Tree_Sp_Name	Eq_0	Eq_1	Eq_2	Eq_3	Eq_4	Eq_5	Eq_6	Eq_7	Eq_8	Eq_9	Eq_10	Eq_11	Eq_12	Eq_13	Eq_14	Eq_15	Eq_16	Eq_17	Eq_18	Eq_19	Eq_20	Eq_21	Eq_22	Eq_23	Eq_24	Eq_25	Eq_26	Eq_27	Eq_28	Eq_29	Eq_30	Eq_31	Eq_32	Eq_33	Eq_34	Eq_35	Eq_36	Eq_37	Eq_38	Eq_39	Eq_40	Eq_41	Eq_42	Eq_43	Eq_44	Eq_45	Eq_46	Eq_47	Eq_48	Eq_49	Eq_50	Eq_51	Eq_52	Eq_53	Eq_54	Eq_55	Eq_56	Eq_57	Eq_58	Eq_59	Eq_60	Eq_61	Eq_62	Eq_63	Eq_64	Eq_65	Eq_66	Eq_67	Eq_68	Eq_69	Eq_70	Eq_71	Eq_72	Eq_73	Eq_74	Eq_75	Eq_76	Eq_77	Eq_78	Eq_79	Eq_80	Curr_Name
Sphenodon_punctatus	Hatteria_punctata	Sphenodon_guntheri	Sphenodon_punctatus_reischeki	Sphenodon_punctatus
Gonyosoma_prasinus	Coluber_prasinus	Elaphe_prasina	Rhadinophis_prasina	Gonyosoma_prasinum
Gonyosoma_margaritatus	Gonyophis_margaritatus	Gonyosoma_margaritatum
Gonyosoma_frenatus	Chrysopelea_ornata_lungchuanensis	Chrysopelea_ornata_lungchuanensis	Coluber_frenatus	Elaphe_frenata	Gonyosoma_caldwelli	Herpetrodryas_frenatus	Rhadinophis_frenatus	Rhadinophis_melli	Gonyosoma_frenatum
Coelognathus_enganensis	Coluber_enganensis	Gonyosoma_enganensis	Coelognathus_enganensis
Euprepiophis_perlacea	Elaphe_perlacea	Euprepiophis_perlaceus
Orthriophis_taeniurus	Coluber_friesi	Coluber_nuthalli	Coluber_nuthalli	Coluber_schmackeri	Coluber_taeniurus_pallidus	Coluber_taeniurus_friesi	Coluber_vaillanti	Compsosoma_leopardum	Elaphe_taeniurus	Elaphis_grabowskyi	Elaphis_yunnanensis	Orthriophis_taeniurus	Orthriophis_taeniurus_callicyanous	Orthriophis_taeniurus_helfenbergeri	Elaphe_taeniura
Orthriophis_hodgsoni	?_hodgsoni	Coluber_hodgsonii	Compsosoma_hodgsonii	Elaphe_hodgsoni	Gonyosoma_hodgsoni	Orthriophis_hodgsonii	Spilotes_hodgsonii	Elaphe_hodgsoni
Orthriophis_moellendorffi	Coluber_moellendorffi	Cynophis_moellendorffi	Elaphe_moellendorffii	Orthriophis_moellendorfi	Elaphe_moellendorffi
Orthriophis_cantoris	Coluber_cantoris	Coluber_reticularis	Orthriophis_cantoris	Elaphe_cantoris
Rhinechis_scalaris	Coluber_elaphis	Coluber_hermannii	Coluber_quater_radiatus	Coluber_scalaris	Elaphe_scalaris	Rhinechis_agassizii	Rhinechis_scalaris	Xenodon_michahelles	Zamenis_scalaris
Cyclophiops_semicarinatus	Cyclophiops_semicarinatus	Cyclophis_nebulosus	Eurypholis_semicarinatus	Liopeltis_semicarinatus_fritzei	Ptyas_semicarinata
Cyclophiops_herminae	Ablabes_herminae	Cyclophiops_herminae	Eurypholis_herminae	Liopeltis_herminae	Opheodrys_herminae	Ptyas_herminae
Cyclophiops_multicinctus	Ablabes_multicinctus	Cyclophiops_multicinctus	Liopeltis_sinii	Ptyas_multicincta
Cyclophiops_hamptoni	Ablabes_doriae	Ablabes_hamptoni	Cyclophiops_doriae	Cyclophiops_hamptoni	Entechinus_doriae	Eurypholis_doriae	Liopeltis_doriae	Ophiodrys_doriae	Ptyas_hamptoni	Ptyas_doriae
Cyclophiops_major	Ablabes_major	Coluber_delacouri	Cyclophiops_major	Cyclophis_major	Enchodus_major	Entechinus_major	Eurypholis_major	Herpetodryas_chloris	Liopeltis_major	Liopeltis_major_bicarinata	Opheodrys_major	Ptyas_major
Cyclophiops_doriae	Ablabes_doriae	Ablabes_hamptoni	Cyclophiops_doriae	Cyclophiops_hamptoni	Entechinus_doriae	Eurypholis_doriae	Liopeltis_doriae	Ophiodrys_doriae	Ptyas_hamptoni	Ptyas_doriae
Drymarchon_margaritae	Drymarchon_margaritae
Mastigodryas_moratoi	Mastigodryas_moratoi
Mastigodryas_bifossatus	Coluber_bifossatus	Coluber_capistratus	Coluber_lichtensteinii	Coluber_pantherinus	Dryadophis_bifossatus_villelai	Drymobius_bifossatus	Drymobius_bifossatus_striatus	Drymobius_bifossatus_triseriatus	Mastigodryas_bifossatus	Mastigodryas_bifossatus_lacerdai	Mastigodryas_bifossatus_striatus	Mastigodryas_bifossatus_triseriatus	Palusophis_bifossatus
Mastigodryas_pleii	Alsophis_pulcher	Dromicus_pleii	Dryadophis_pleei	Herpetodryas_quinquelineatus	Mastigodryas_pleii
Drymoluber_apurimacensis	Drymoluber_apurimacensis
Chionactis_palarostris	Chionactis_palarostris	Chionactis_palarostris_organica	Chionactis_palarostris_palarostris	Sonora_palarostris	Sonora_palarostris
Chionactis_occipitalis	?_occipitalis	Chionactis_occipitalis	Chionactis_occipitalis_occipitalis	Chionactis_occipitalis_talpina	Chionactis_saxatilis	Rhinostoma_occipitale	Sonora_occipitalis
Chilomeniscus_stramineus	Chilomeniscus_ephippicus	Chilomeniscus_punctatissimus	Chilomeniscus_punctatissimus	Chilomeniscus_stramineus	Sonora_straminea
Chilomeniscus_savagei	Chilomeniscus_savagei	Sonora_savagei
Tantilla_sertula	Tantilla_sertula
Tantilla_cascadae	Tantilla_cascadae
Tantilla_tecta	Tantilla_tecta
Tantilla_marcovani	Coluber_melanocephalus	Elapomorphus_mexicanus	Elapomorphus_nuchalis	Elaps_melanocephalus	Homalocranium_armillatum	Homalocranium_hoffmanni	Homalocranium_longifrontale	Homalocranium_melanocephalum_fraseri	Homalocranium_melanocephalum_fuscum	Homalocranium_melanocephalum_melanocephalum	Homalocranium_melanocephalum_pernambucense	Tantilla_fraseri	Tantilla_longifrontalis	Tantilla_marcovani	Tantilla_melanocephala_melanocephala	Tantilla_pallida	Tantilla_melanocephala
Pseustes_sexcarinatus	Chironius_cinnamomeus	Erpetodryas_4dricarinatus	Erpetodryas_quadricarinatus	Natrix_cinnamomea	Natrix_sexcarinatus	Phrynonax_sexcarinatus	Phyllosira_flavescens	Pseustes_cinnamomeus	Pseustes_sexcarinatus	Chironius_quadricarinatus
Pseustes_cinnamomeus	Chironius_cinnamomeus	Erpetodryas_4dricarinatus	Erpetodryas_quadricarinatus	Natrix_cinnamomea	Natrix_sexcarinatus	Phrynonax_sexcarinatus	Phyllosira_flavescens	Pseustes_cinnamomeus	Pseustes_sexcarinatus	Chironius_quadricarinatus
Pseustes_shropshirei	Phrynonax_shropshirei	Pseustes_shropshirei	Phrynonax_shropshirei
Pseustes_poecilonotus	Phrynonax_guentheri	Pseustes_poecilonotus	Spilotes_argus	Spilotes_chrysobronchus	Spilotes_poecilonotus	Synchalinus_corallioides	Tropidodipsas_lunulata	Phrynonax_poecilonotus
Coluber_aurigulus	Bascanium_aurigulum	Bascanium_laterale_aurigulum	Coluber_aurigulus	Coluber_flagelliformis_aurigulus	Drymobius_aurigulus	Zamensis_aurigulus	Masticophis_aurigulus
Coluber_barbouri	Coluber_aurigulus_barbouri	Coluber_barbouri	Masticophis_barbouri
Coluber_anthonyi	Bascanion_anthonyi	Coluber_anthonyi	Masticophis_anthonyi
Coluber_mentovarius	?_mentovarius	Bascanion_lineatum	Bascanion_suboculare	Coluber_lineatus	Coluber_mentovarius	Coluber_striolatus	Coryphodon_mento-varius	Masticophis_flagellum_variolosus	Spilotes_corais_suborbitalis	Masticophis_mentovarius
Coluber_taeniatus	Coluber_taeniatus	Coluber_taeniatus_girardi	Coluber_taeniatus_taeniatus	Leptophis_taeniata	Masticophis_ornatus	Masticophis_taeniatus
Coluber_lateralis	Coluber_lateralis	Coluber_lateralis_lateralis	Leptophis_lateralis	Masticophis_lateralis
Coluber_fuliginosus	Atractus_univittatus	Coluber_fuliginosus	Rhabdosoma_univittatum	Atractus_fuliginosus
Coluber_flagellum	Bascanion_flagellum_frenatum	Bascanion_piceum	Bascanium_flagelliforme_bicinctum	Coluber_americanus	Coluber_flagellum	Coluber_testaceus	Psammophis_flavigularis	Masticophis_flagellum
Chironius_diamantina	Chironius_diamantina
Chironius_leucometapus	Chironius_fuscus_leucometapus	Chironius_leucometapus
Argyrogena_vittacaudata	Coluber_vittacaudatus	Argyrogena_vittacaudata
Gongylosoma_baliodeirus	Coronella_baliodeira	Liopeltis_baliodeirus_cochranae	Gongylosoma_baliodeira
Gongylosoma_scripta	Ablabes_scriptus	Liopeltis_scriptus	Gongylosoma_scriptum
Gongylosoma_nicobariensis	Ablabes_nicobariensis	Gongylosoma_nicobariensis
Gongylosoma_mukutense	Gongylosoma_mukutense	Gongylosoma_mukutense
Boiga_saengsomi	Boiga_saengsomi
Boiga_tanahjampeana	Boiga_tanahjampeana
Boiga_bourreti	Boiga_bourreti	Boiga_bourreti
Boiga_dightoni	Dipsadomorphus_dightoni	Dipsas_dightoni	Boiga_dightoni
Boiga_gokool	Boiga_gokool	Dipsas_gocool	Dipsas_gokool	Dipsus_gocool	Boiga_gocool
Telescopus_gezirae	Telescopus_gezirae
Liopeltis_philippinus	Ablabes_philippinus	Liopeltis_philippina
Liopeltis_frenatus	Cyclophis_frenatus	Eirenis_frenatus	Liopeltis_frenata
Elachistodon_westermanni	Elachistodon_westermanni	Boiga_westermanni
Lepturophis_albofuscus	?_albofuscus	Lepturophis_albofuscus	Lepturophis_borneensis	Sphecodes_albo-fuscus	Sphecodes_albo-fuscus	Lycodon_albofuscus
Tetralepis_fruhstorferi	Tetralepis_fruhstorferi
Dasypeltis_latericia	Dasypeltis_gansi_laterica	Dasypeltis_latericia
Dasypeltis_abyssina	Dasypeltis_abyssinus	Rachiodon_abyssinus	Dasypeltis_abyssina
Stegonotus_florensis	Lycodon_florensis	Stegonotus_florensis
Stegonotus_borneensis	Stegonotus_borneensis
Lycodon_meridionale	Dinodon_meridionale	Lycodon_meridionale
Lycodon_tessellatus	Lycodon_tessellatus
Lycodon_zoosvictoriae	Lycodon_zoosvictoriae
Lycodon_multizonatus	Oligodon_multizonatum	Lycodon_multizonatus
Lycodon_davidi	Lycodon_davidi
Lycodon_fausti	Lycodon_fausti
Lycodon_osmanhilli	Lycodon_osmanhilli	Lycodon_anamallensis
Lycodon_odishii	Coluber_jara	Lycodon_odishii	Lycophidion_bipunctatum	Lycodon_jara
Dryocalamus_philippinus	Dryocalamus_philippinus	Lycodon_philippinus
Dryocalamus_subannulatus	?_subannulatus	Coronella_prosopeion	Dryocalamus_davisonii_tungsongensis	Dryocalamus_subannulatus	Nymphodidium_maculatum	Odontomus_sub-annulatus	Lycodon_subannulatus
Dryocalamus_tristrigatus	Dryocalamus_tristrigatus	Lycodon_tristrigatus
Dryocalamus_davisonii	?_davisonii	Dryocalamus_davisonii	Ulupe_davisoni	Lycodon_davisonii
Dryocalamus_gracilis	Dryocalamus_gracilis	Hydrophobus_gracilis	Odontomus_fergusonii	Odontomus_gracilis	Lycodon_gracilis
Dryocalamus_nympha	Cochliophagus_isolepis	Coluber_nympha	Dryocalamus_nympha	Hurria_nympha	Hydrophobus_nympha	Hydrophobus_semifasciatus	Odontomus_nympha	Odontomus_semifasciatus	Lycodon_nympha
Hapsidophrys_smaragdina	Dendrophis_smaragdina	Hapsidophrys_coeruleus	Hapsidophrys_smaragdina_eror	Leptophis_gracilis	Tropidophidion_steini	Hapsidophrys_smaragdinus
Macroprotodon_abubakeri	Macroprotodon_abubakeri
Coluber_bholanathi	Argyrogena_bholanathi	Coluber_bholanathi	Eremiophis_bholanathi	Platyceps_bholanathi
Coluber_zebrinus	Coluber_zebrinus	Hemerophis_zebrinus	Mopanveldophis_zebrinus
Aprosdoketophis_andreonei	Aprosdoketophis_andreonei
Spalerosophis_josephscorteccii	Spalerosophis_josephscorteccii
Platyceps_tessellata	Zamenis_rhodorhachis_tessellata	Platyceps_tessellata
Platyceps_messanai	Coluber_messanai	Platyceps_messanai
Platyceps_scortecci	Coluber_scortecci	Platyceps_scortecci
Platyceps_largeni	Coluber_largeni	Platyceps_largeni
Hierophis_andreanus	Coluber_andreanus	Hierophis_andreanus	Zamenis_andreanus	Dolichophis_andreanus
Eirenis_thospitis	Eirenis_thospitis
Eirenis_hakkariensis	Eirenis_hakkariensis
Eirenis_africana	Contia_africana	Eirenis_africanus
Eirenis_kermanensis	Eirenis_kermanensis
Eirenis_aurolineatus	Contia_collaris_aurolineata	Contia_collaris_aurolineata	Eirenis_aurolineatus
Rhynchocalamus_arabicus	Rhynchocalamus_arabicus
Rhynchocalamus_barani	Rhynchocalamus_barani	Muhtarophis_barani
Scaphiophis_raffreyi	Scaphiophis_calciatti	Scaphiophis_raffreyi
Oligodon_unicolor	Simotes_unicolor	Oligodon_unicolor
Oligodon_wagneri	Oligodon_wagneri
Oligodon_lungshenensis	Oligodon_guizhouensis	Oligodon_lungshenensis	Oligodon_lungshenensis
Oligodon_pulcherrimus	Oligodon_annulifer_bipartita	Oligodon_durheimi	Oligodon_pulcherimus	Oligodon_pulcherrimus	Oligodon_pulcherrimus
Oligodon_jintakunei	Oligodon_jintakunei
Oligodon_nikhili	Oligodon_nikhili
Oligodon_moricei	Oligodon_moricei
Oligodon_melanozonatus	Oligodon_melanozonatus
Oligodon_propinquus	Oligodon_propinquus
Oligodon_eberhardti	Macrocalamus_wongii	Oligodon_herberti_eberhardti	Rhynchocalamus_eberhardti	Oligodon_eberhardti
Oligodon_inornatus	Simotes_inornatus	Oligodon_inornatus
Oligodon_petronellae	Oligodon_annulifer_confluens	Oligodon_petronellae	Oligodon_rouxi	Oligodon_petronellae
Oligodon_erythrorhachis	Oligodon_erythrorhachis
Oligodon_saintgironsi	Oligodon_saintgironsi
Oligodon_praefrontalis	Oligodon_praefrontalis
Dendrelaphis_oliveri	Ahaetulla_oliveri	Dendrelaphis_oliveri
Dendrelaphis_salomonis	Ahaetulla_calligastra	Dendrelaphis_calligastra	Dendrelaphis_papuensis	Dendrelaphis_salomonis	Dendrelaphis_schlenckeri	Dendrophis_aruensis	Dendrophis_calligaster	Dendrophis_calligaster	Dendrophis_calligastra	Dendrophis_calligastra_distinguendus	Dendrophis_calligastra_keiensis	Dendrophis_darnleyensis	Dendrophis_katowensis	Dendrophis_salomonis	Dendrelaphis_calligaster
Dendrelaphis_lorentzi	Dendrophis_lorentzii	Dendrelaphis_lorentzii
Dendrelaphis_calligastra	Ahaetulla_calligastra	Dendrelaphis_calligastra	Dendrelaphis_papuensis	Dendrelaphis_salomonis	Dendrelaphis_schlenckeri	Dendrophis_aruensis	Dendrophis_calligaster	Dendrophis_calligaster	Dendrophis_calligastra	Dendrophis_calligastra_distinguendus	Dendrophis_calligastra_keiensis	Dendrophis_darnleyensis	Dendrophis_katowensis	Dendrophis_salomonis	Dendrelaphis_calligaster
Chrysopelea_rhodopleuron	Chrysopelea_viridis	Leptophis_doleschalii	Chrysopelea_rhodopleuron
Oreocalamus_hanitschi	Oreocalamus_hanitschi
Pseudorabdion_saravacense	Agrophis_saravacensis	Pseudorabdion_saravacense
Pseudorabdion_modiglianii	Pseudorabdion_modiglianii
Pseudorabdion_sirambense	Pseudorabdion_sirambense
Calamorhabdium_kuekenthali	Calamorhabdium_kuekenthali
Calamorhabdium_acuticeps	Calamorhabdium_acuticeps
Collorhabdium_williamsoni	Collorhabdium_williamsoni
Etheridgeum_pulchrum	Padangia_pulchra	Etheridgeum_pulchrum
Rhabdops_bicolor	?_bicolor	Ablabes_bicolor	Grotea_bicolor	Pseudocyclophis_bicolor	Rhabdops_bicolor	Smithophis_bicolor
Macrocalamus_vogeli	Macrocalamus_vogeli
Macrocalamus_jasoni	Macrocalamus_jasoni
Calamaria_sangi	Calamaria_sangi
Calamaria_margaritophora	Calamaria_hoevenii	Calamaria_maculolineata	Calamaria_margaritophora
Calamaria_brongersmai	Calamaria_virgulata	Calamaria_brongersmai
Calamaria_javanica	Calamaria_javanica
Calamaria_abramovi	Calamaria_abramovi
Calamaria_doederleini	Calamaria_doederleini
Calamaria_rebentischi	Calamaria_rebentischi
Calamaria_mecheli	Calamaria_mehelyi	Calamaria_mecheli
Calamaria_concolor	Calamaria_concolor
Calamaria_palawanensis	Calamaria_palawanensis
Calamaria_battersbyi	Calamaria_melanota	Calamaria_battersbyi
Calamaria_pfefferi	Calamaria_pavimentata	Calamaria_pfefferi
Calamaria_crassa	Calamaria_crassa
Calamaria_buchi	Calamaria_buchi
Calamaria_thanhi	Calamaria_thanhi
Calamaria_gracillima	Typhlocalamus_gracillima	Calamaria_gracillima
Calamaria_eiselti	Calamaria_eiselti
Calamaria_butonensis	Calamaria_butonensis
Calamaria_lautensis	Calamaria_lautensis
Calamaria_alidae	Calamaria_alidae
Calamaria_ulmeri	Calamaria_ulmeri
Calamaria_ingeri	Calamaria_ingeri
Calamaria_longirostris	Calamaria_longirostris
Calamaria_prakkei	Calamaria_prakkei
Calamaria_forcarti	Calamaria_forcarti
Calamaria_gialaiensis	Calamaria_gialaiensis
Calamaria_boesemani	Calamaria_boesemani
Synophis_plectovertebralis	Synophis_plectovertebralis
Omoadiphas_cannula	Omoadiphas_cannula
Pliocercus_wilmarai	Elapochrus_deppei	Liophis_elapoides_diastema	Liophis_elapoides_diastemus	Liophis_tricinctus	Pleiocercus_aequalis	Pliocercus_andrewsi	Pliocercus_andrewsi_pacificus	Pliocercus_bicolor	Pliocercus_elapoides_celatus	Pliocercus_elapoides_diastemus	Pliocercus_elapoides_hobartsmithi	Pliocercus_elapoides_laticollaris	Pliocercus_elapoides_salvadorensis	Pliocercus_elapoides_schmidti	Pliocercus_elapoides_semicinctus	Pliocercus_salvinii	Pliocercus_sargii	Pliocercus_wilmarai	Urotheca_andrewsi	Urotheca_bicolor	Urotheca_elapoides	Pliocercus_elapoides
Coniophanes_joanae	Coniophanes_joanae
Coniophanes_longinquus	Coniophanes_longinquus
Coniophanes_sarae	Coniophanes_sarae	Coniophanes_lateritius
Rhadinaea_stadelmani	Rhadinaea_stadelmani	Rhadinella_stadelmani
Rhadinophanes_monticola	Rhadinophanes_monticola
Emmochliophis_miops	Synophis_miops	Emmochliophis_miops
Atractus_multidentatus	Atractus_multidentatus	Atractus_multidentatus
Atractus_avernus	Atractus_avernus
Atractus_edioi	Atractus_edioi
Atractus_arangoi	Atractus_arangoi	Atractus_major
Atractus_altagratiae	Atractus_altagratiae
Atractus_ayeush	Atractus_ayeush
Atractus_savagei	Atractus_savagei
Atractus_alytogrammus	Atractus_alytogrammus_kohler	Atractus_alytogrammus
Atractus_thalesdelemai	Atractus_kangueryensis	Atractus_thalesdelemai
Atractus_boettgeri	Atractus_balzani	Atractus_boettgeri	Atractus_paravertebralis	Atractus_taeniatus	Geophis_emmeli	Atractus_emmeli
Atractus_limitaneus	Atractus_limitaneus	Leptocalamus_limitaneus	Leptocalamus_limitaneus	Atractus_collaris
Atractus_taphorni	Atractus_taphorni
Atractus_paravertebralis	Atractus_balzani	Atractus_boettgeri	Atractus_paravertebralis	Atractus_taeniatus	Geophis_emmeli	Atractus_emmeli
Atractus_spinalis	Atractus_spinalis
Atractus_mariselae	Atractus_mariselae
Atractus_vittatus	Atractus_vittatus
Atractus_macondo	Atractus_macondo
Atractus_microrhynchus	Rhabdosoma_microrhynchum	Atractus_microrhynchus
Atractus_nasutus	Atractus_nasutus
Atractus_alphonsehogei	Atractus_alphonsehogei
Atractus_caete	Atractus_caete
Atractus_eriki	Atractus_eriki
Atractus_medusa	Atractus_medusa
Atractus_univittatus	Atractus_univittatus	Coluber_fuliginosus	Rhabdosoma_univittatum	Atractus_fuliginosus
Atractus_insipidus	Atractus_insipidus
Atractus_hoogmoedi	Atractus_hoogmoedi
Atractus_emigdioi	Atractus_emigdioi
Atractus_nigricaudus	Atractus_nigricauda
Atractus_francoi	Atractus_francoi
Atractus_tamaensis	Atractus_tamaensis
Atractus_matthewi	Atractus_nororientalis	Atractus_matthewi
Atractus_acheronius	Atractus_acheronius
Atractus_caxiuana	Atractus_caxiuana
Atractus_micheleae	Atractus_micheleae
Atractus_apophis	Atractus_apophis
Atractus_hostilitractus	Atractus_hostilitractus
Atractus_attenuates	Atractus_attenuates
Atractus_mijaresi	Atractus_mijaresi
Atractus_vertebralis	Atractus_vertebralis
Atractus_echidna	Atractus_echidna
Atractus_surucucu	Atractus_surucucu	Atractus_surucucu
Atractus_taeniatus	Atractus_balzani	Atractus_boettgeri	Atractus_paravertebralis	Atractus_taeniatus	Geophis_emmeli	Atractus_emmeli
Atractus_ochrosetrus	Atractus_ochrosetrus
Atractus_balzani	Atractus_balzani	Atractus_boettgeri	Atractus_paravertebralis	Atractus_taeniatus	Geophis_emmeli	Atractus_emmeli
Atractus_meridensis	Atractus_meridensis
Ninia_franciscoi	Ninia_franciscoi
Sibon_linearis	Sibon_linearis
Sibon_perissostichon	Sibon_perissostichon_kohler	Sibon_perissostichon
Dipsas_petersi
Sibynomorphus_ventrimaculatus	Cochliophagus_ventrimaculatus	Dipsas_poecilolepis	Heterorhachis_poecilolepis	Heterorhachis_poecilolepis	Heterorhachis_poecilolepsis	Leptognathus_intermedius	Leptognathus_ventrimaculatus	Sibynomorphus_ventrimaculatus	Dipsas_ventrimaculata
Sibynomorphus_lavillai	Sibynomorphus_lavillai	Dipsas_lavillai
Sibynomorphus_neuwiedi	Cochliophagus_mikanii_neuwiedi	Sibynomorphus_mikanii_fasciatus	Sibynomorphus_neuwiedi	Dipsas_neuwiedi
Sibynomorphus_petersi	Sibynomorphus_petersi	Dipsas_jamespetersi
Sibynomorphus_vagus	Leptognathus_vagus	Sibynomorphus_vagus	Dipsas_vagus
Sibynomorphus_oligozonatus	Sibynomorphus_oligozonatus	Dipsas_oligozonata
Sibynomorphus_vagrans	Pseudopareas_vagrans	Sibynomorphus_vagrans	Dipsas_vagrans
Dipsas_neivai	Dipsas_neivai	Leptognathus_robusta	Leptognathus_variegatus	Dipsas_variegata
Sibynomorphus_turgidus	Cochliophagus_inaequifasciatus	Leptognathus_turgida	Sibynomorphus_inaequifasciatus	Sibynomorphus_inequifasciatus	Sibynomorphus_turgidus	Tropidodipsas_spilogaster	Dipsas_turgida
Sibynomorphus_oneilli	Sibynomorphus_oneilli	Dipsas_oneilli
Sibynomorphus_mikanii	Leptognathus_garmani	Sibynomorphus_mikanii	Sibynomorphus_mikanii_septentrionalis	Dipsas_mikanii
Sibynomorphus_williamsi	Sibynomorphus_williamsi	Dipsas_williamsi
Dipsas_baliomelas	Dipsas_baliomelas
Tropidodipsas_annuliferus	Geophis_tecpanecus	Sibon_annuliferus	Tantilla_nelsoni	Tropidodipsas_malacodryas	Tropidodipsas_annulifera
Geophis_isthmicus	Atractus_isthmicus	Geophis_isthmicus
Adelphicos_daryi	Adelphicos_daryi
Adelphicos_ibarrorum	Adelphicos_ibarrorum
Hypsiglena_ochrorhyncha	Hypsiglena_nuchalatus	Hypsiglena_torquata_gularis	Hypsiglena_torquata_klauberi	Hypsiglena_torquata_venusta	Hypsiglena_ochrorhynchus
Trimetopon_viquezi	Trimetopon_viquezi
Taeniophallus_nebularis	Taeniophallus_nebularis
Phalotris_punctatus	Elapomorphus_punctatus	Elapomorphus_tricolor	Phalotris_punctatus	Phalotris_tricolor
Phalotris_bilineatus	Elapomorphus_bilineatus	Elapomorphus_bilineatus_lemniscatus	Elapomorphus_bollei	Elapomorphus_iheringi	Elapomorphus_lemniscatus	Elapomorphus_lemniscatus	Elapomorphus_lemniscatus_lemniscatus	Elapomorphus_spegazzinii	Elapomorphus_spegazzinii_suspectus	Elapomorphus_suspectus	Elapomorphus_trilineatus	Phalotris_bilineatus	Phalotris_divittatus	Phalotris_melanopleurus	Phalotris_melanopleurus	Phalotris_lemniscatus
Phalotris_concolor	Phalotris_cerradensis	Phalotris_concolor
Phalotris_nigrilatus	Phalotris_nigrilatus
Apostolepis_striata	Apostolepis_striata
Apostolepis_quirogai	Apostolepis_quirogai
Apostolepis_niceforoi	Apostolepis_niceforoi	Apostolepis_niceforoi
Apostolepis_ammodites	Apostolepis_ammodites	Apostolepis_sanctaeritae
Apostolepis_parassimilis	Apostolepis_parassimilis	Apostolepis_tertulianobeui	Elapomorphus_assimilis	Apostolepis_assimilis
Apostolepis_breviceps	Apostolepis_breviceps	Apostolepis_breviceps
Apostolepis_longicaudata	Apostolepis_longicaudata	Apostolepis_longicaudata
Apostolepis_gaboi	Apostolepis_gaboi
Elapomorphus_spegazzinii	Elapomorphus_bilineatus	Elapomorphus_bilineatus_lemniscatus	Elapomorphus_bollei	Elapomorphus_iheringi	Elapomorphus_lemniscatus	Elapomorphus_lemniscatus	Elapomorphus_lemniscatus_lemniscatus	Elapomorphus_spegazzinii	Elapomorphus_spegazzinii_suspectus	Elapomorphus_suspectus	Elapomorphus_trilineatus	Phalotris_bilineatus	Phalotris_divittatus	Phalotris_melanopleurus	Phalotris_melanopleurus	Phalotris_lemniscatus
Hydrodynastes_melanogigas	Cyclagras_gigas	Hydrodynastes_melanogigas	Lejosophis_gigas	Xenodon_gigas	Hydrodynastes_gigas
Tachymenis_tarmensis	Tachymenis_tarmensis
Tachymenis_elongata	Alsophis_elegans	Dromicus_rufodorsatus	Dryophylax_elegans	Dryophylax_freminvillei	Dryophylax_vitellinus	Lygophis_elegans	Lygophis_poecilostomus	Philodryas_elegans	Philodryas_freminvillei	Tachymenis_canilatus	Tachymenis_elongata	Tachymenis_surinamensis	Pseudalsophis_elegans
Thamnodynastes_chimanta	Thamnodynastes_chimanta
Thamnodynastes_longicaudus	Thamnodynastes_longicauda
Thamnodynastes_almae	Thamnodynastes_almae
Thamnodynastes_yavi	Thamnodynastes_yavi
Thamnodynastes_corocoroensis	Thamnodynastes_corocoroensis
Thamnodynastes_duida	Thamnodynastes_duida
Thamnodynastes_marahuaquensis	Thamnodynastes_marahuaquensis
Tomodon_dorsatum	Aproterodon_clementei	Opisthoplus_degener	Tomodon_dorsatum	Tomodon_dorsatus
Calamodontophis_ronaldoi	Calamodontophis_dorsolineatus	Calamodontophis_ronaldoi
Eutrachelophis_steinbachi	Aporophis_melanocephalus	Erythrolamprus_steinbachi	Eutrachelophis_steinbachi	Liophis_steinbachi	Rhadinaea_steinbachi	Baliodryas_steinbachi
Eutrachelophis_bassleri	Eutrachelophis_bassleri
Amnesteophis_melanauchen	Enicognathus_melanauchen	Liophis_melanauchen	Amnesteophis_melanauchen
Ditaxodon_taeniatus	Ditaxodon_taeniatus	Philodryas_taeniatus	Ditaxodon_taeniatus
Pseudoboa_serrana	Pseudoboa_serrana	Pseudoboa_serrana
Clelia_hussami	Clelia_hussami
Clelia_errabunda	Clelia_errabunda
Rodriguesophis_scriptorcibatus	Phimophis_scriptorcibatus	Rodriguesophis_scriptorcibatus
Siphlophis_leucocephalus	Leptodira_leucocephalus	Lycognathus_rhombeatus	Siphlophis_leucocephalus
Helicops_yacu	Helicops_yacu
Philodryas_viridissima	Coluber_ianthinus	Coluber_viridissimus	Philodryas_affinis	Philodryas_crassifrons	Philodryas_viridissima	Chlorosoma_viridissimum
Philodryas_georgeboulengeri	Oxybelis_boulengeri	Philodryas_georgeboulengeri	Xenoxybelis_boulengeri
Philodryas_argentea	Coluber_argenteus	Coluber_argenteus	Oxybelis_argenteus	Philodryas_argentea	Xenoxybelis_argenteus
Philodryas_laticeps	Philodryas_laticeps	Philodryas_oligolepis	Chlorosoma_laticeps
Philodryas_amaru	Philodryas_amaru	Incaspis_amaru
Philodryas_livida	Platyinion_lividum	Platyinion_lividum	Philodryas_livida
Philodryas_simonsii	Dromicus_angustilineatus	Dromicus_inca	Incaspis_cercostropha	Philodryas_simonsii	Incaspis_simonsii
Philodryas_tachymenoides	Dromicus_tachymenoides	Liophis_tachymenoides	Philodryas_tachymenoides	Incaspis_tachymenoides
Saphenophis_atahuallpae	Liophis_atahuallpae	Saphenophis_atahuallpae
Xenodon_nattereri	Heterodon_nattereri	Lystrophis_nattereri	Xenodon_nattereri
Xenodon_merremi	Ophis_merremii	Trigonocephalus_alternatus_binocularius	Trigonocephalus_flavescens	Waglerophis_merremi	Xenodon_irregularis	Xenodon_merremii
Erythrolamprus_torrenicola	Liophis_torrenicola	Erythrolamprus_torrenicola
Erythrolamprus_albertguentheri	Liophis_guentheri	Erythrolamprus_albertguentheri
Erythrolamprus_carajasensis	Liophis_carajascinsis	Liophis_carajasensis	Erythrolamprus_carajasensis
Erythrolamprus_janaleeae	Liophis_janaleeae	Erythrolamprus_janaleeae
Erythrolamprus_trebbaui	Liophis_trebbaui	Erythrolamprus_trebbaui
Erythrolamprus_longiventris	Erythrolamprus_breviceps_breviceps	Erythrolamprus_breviceps_canaima	Erythrolamprus_longiventris	Liophis_breviceps	Liophis_canaima	Liophis_longiventris	Erythrolamprus_breviceps
Erythrolamprus_ingeri	Liophis_ingeri	Erythrolamprus_ingeri
Erythrolamprus_subocularis	Liophis_subocularis	Rhadinaea_subocularis	Erythrolamprus_subocularis
Erythrolamprus_problematicus	Erythrolamprus_problematicus	Liophis_problematicus	Arcanumophis_problematicus
Arrhyton_ainictum	Arrhyton_ainictum
Arrhyton_procerum	Arrhyton_procerum
Magliophis_exiguum	Arrhyton_exiguus	Dromicus_exiguus	Magliophis_exiguus
Hypsirhynchus_scalaris	Hypsirhynchus_ferox_scalaris	Hypsirhynchus_scalaris
Cubophis_ruttyi	Alsophis_angulifer_ruttyi	Alsophis_ruttyi	Cubophis_ruttyi
Alsophis_sajdaki	Alsophis_sajdaki
Conophis_morai	Conophis_morai
Thalesius_viridis	Procteria_viridis	Thalesius_viridis	Xenodon_werneri	Xenodon_werneri
Thermophis_zhaoermii	Thermophis_zhaoermii
Stichophanes_ningshaanensis	Oligodon_ningshaanensis	Stichophanes_ningshaanensis
Heterodon_gloydi	Heterodon_gloydi	Heterodon_nasicus_gloydi	Heterodon_nasicus_nasicus	Heterodon_nasicus
Plagiopholis_unipostocularis	Oligodon_kunmingensis	Plagiopholis_unipostocularis	Plagiopholis_blakewayi
Pseudoxenodon_baramensis	Tropidonotus_baramensis	Pseudoxenodon_baramensis
Rhabdophis_callichroma	Natrix_auchenia	Natrix_chrysarga_callichroma	Rhabdophis_callichroma
Rhabdophis_adleri	Rhabdophis_adleri
Rhabdophis_auriculata	Rhabdophis_auriculata_myersi	Rhabdophis_auriculatus	Tropidonotus_auriculatus	Rhabdophis_auriculatus
Rhabdophis_akraios	Rhabdophis_akraios
Balanophis_ceylonensis	Amphiesma_ceylonensis	Balanophis_ceylonensis	Tropidonotus_ceylonensis	Tropidonotus_chrysargus_ceylonensis	Tropidonotus_chrysargus_ceylonensis	Rhabdophis_ceylonensis
Rhabdophis_angeli	Natrix_angelii	Rhabdophis_angeli
Rhabdophis_callistus	Tropidonotus_callistus	Rhabdophis_callistus
Xenochrophis_sanctijohannis	?_sanctijohannis	Natrix_piscator_sancti-johannis	Nerodia_piscator_sancti-johannis	Tropidonotus_piscator_obscurus	Tropidonotus_piscator_unicolor	Tropidonotus_sancti-johannis	Xenochrophis_piscator_sanctijohannis	Xenochrophis_sanctijohannis	Fowlea_sanctijohannis
Xenochrophis_punctulatus	Fowlea_peguensis	Natrix_punctulata	Nerodia_punctulata	Tropidonotus_punctulatus	Xenochrophis_punctulatus	Fowlea_punctulatus
Xenochrophis_flavipunctatus	Amphiesma_flavipunctatum	Col_quincunciatus	Nerodia_piscator	Tropidonotus_piscator_ornatus	Xenochrophis_flavipunctatus	Fowlea_flavipunctatus
Xenochrophis_asperrimus	Tropidonotus_asperrimus	Xenochrophis_asperrimus	Fowlea_asperrimus
Xenochrophis_schnurrenbergeri	Xenochrophis_flavipunctatus_schnurrenbergeri	Xenochrophis_schnurrenbergeri	Fowlea_schnurrenbergeri
Xenochrophis_melanzostus	Coluber_lippus	Coluber_melanzostus	Tropidonotus_quincunciatus	Xenochrophis_melanzostus	Fowlea_melanzostus
Xenochrophis_bellula	Tropidonotus_bellulus	Xenochrophis_bellulus
Xenochrophis_tytleri	Tripidonotus_tytleri	Tropidonotus_striolatus	Tropidonotus_striolatus_pro	Tropidonotus_tytleri	Xenochrophis_tytleri	Fowlea_tytleri
Pararhabdophis_chapaensis	Pararhabdophis_chapaensis	Hebius_chapaensis
Macropisthodon_rudis	Macropisthodon_rudis	Macropisthodon_rudis_multiprefrontalis	Macropisthodon_rudis_melanogaster	Natrix_namiei	Pseudagkistrodon_carinatus	Rhabdophis_rudis	Pseudagkistrodon_rudis
Macropisthodon_rhodomelas	Macropisthodon_rhodomelas	Tropidonotus_mortoni	Tropidonotus_rhodomelas	Rhabdophis_rhodomelas
Macropisthodon_plumbicolor	Amphiesma_brachyurum	Macropisthodon_plumbicolor	Macropisthodon_plumbicolor_palabariya	Trigonocephalus_ellioti	Tropidonotus_plumbicolor	Xenodon_viridis	Rhabdophis_plumbicolor
Macropisthodon_flaviceps	Amphiesma_flaviceps	Amphiesma_lindmani	Amphiesma_lindmanni	Amphiesma_rufo_torquatum	Macropisthodon_flaviceps	Rhabdophis_flaviceps
Natriciteres_bipostocularis	Natriciteres_olivacea_bipostocularis	Natriciteres_olivacea_uluguruensis	Natriciteres_bipostocularis
Iguanognathus_werneri	Iguanognathus_werneri
Parahelicops_annamensis	Opisthotropis_annamensis	Parahelicops_annamensis	Hebius_annamensis
Hydrablabes_periops	Ablabes_periops	Hydrablables_periops	Hydrablabes_periops
Hydrablabes_praefrontalis	Ablabes_periops_praefrontalis	Ablabes_periops_praefrontalis	Hydrablables_praefrontalis	Hydrablabes_praefrontalis
Anoplohydrus_aemulans	Anoplohydrus_aemulans
Tropidonophis_punctiventris	Amphiesma_punctiventris	Natrix_punctiventris	Tropidonotus_punctiventris	Tropidonophis_punctiventris
Tropidonophis_statistictus	Tropidonophis_statistictus
Trachischium_laeve	Trachischium_quinquelabialis	Trachischium_laeve
Hebius_khasiense	?_khasiense	Amphiesma_khasiense	Amphiesma_khasiensis	Hebius_khasiense	Natirx_gihodesi	Natirx_gilhodesi	Tropidonotus_khasiensis	Hebius_khasiensis
Hebius_frenatum	Amphiesma_frenatum	Natrix_frenata	Hebius_frenatus
Hebius_modestum	Amphiesma_modestum	Hebius_modestum_eror	Tropidonotus_modestus	Hebius_modestus
Hebius_pealii	Amphiesma_pealii	Hebius_pealii	Tropidonotus_pealii	Herpetoreas_pealii
Hebius_groundwateri	Amphiesma_groundwateri	Natrix_groundwateri	Hebius_groundwateri
Hebius_sanguineum	Amphiesma_sanguineum	Natrix_sanguinea	Hebius_sanguineus
Hebius_ishigakiense	Amphiesma_ishigakiense	Hebius_ishigakiense	Natrix_pryeri_ishigakiense	Natrix_pryeri_ishigakiensis	Hebius_ishigakiensis
Hebius_bitaeniatum	Amphiesma_bitaeniata	Natrix_bitaeniata	Hebius_bitaeniatus
Hebius_kerinciense	Amphiesma_kerinciense	Hebius_kerinciense	Hebius_kerinciense_eror	Hebius_kerinciensis
Hebius_optatum	Amphiesma_optatum	Natrix_optata	Hebius_optatus
Hebius_octolineatum	Amphiesma_octolineatum	Natrix_nigroreticulata	Natrix_septemlineata	Tropidonotus_octolineatus	Tropidonotus_parallelus_sublaevis	Tropidonotus_pleurotaenia	Tropidonotus_quadrilineatus	Hebius_octolineatus
Hebius_metusium	Amphiesma_metusia	Hebius_metusia
Hebius_taronense	?_taronense	Amphiesma_taronense	Amphiesma_taronensis	Amphiesma_venningi_taronensis	Hebius_taronense	Natrix_venningi_taronensis	Natrix_venningi_taronensis	Hebius_taronensis
Hebius_xenura	Amphiesma_xenura	Hebius_xenura	Natrix_xenurus	Tropidonotus_xenura	Herpetoreas_xenura
Hebius_sarawacense	?_sarawacense	Amphiesma_sarawacense	Amphiesma_sarawacensis	Hebius_sarawacense	Tropidonotus_maculatus	Tropidonotus_sarawacensis	Hebius_sarawacensis
Hebius_andreae	Amphiesma_andreae	Hebius_andreae
Hebius_nicobariense	?_nicobariense	Amphiesma_nicobarensis	Amphiesma_nicobariense	Hebius_nicobariense	Tropidonotus_nicobaricus	Tropidonotus_nicobariensis	Hebius_nicobariensis
Hebius_atemporale	?_atemporale	Amphiesma_atemporale	Amphiesma_atemporalis	Hebius_atemporale	Hebius_atemporale_eror	Natrix_atemporalis	Hebius_atemporalis
Hebius_arquus	Amphiesma_arquus	Hebius_arquus
Hebius_concelarum	Amphiesma_concelarum	Amphiesma_pryeri_concelarum	Hebius_concelarus
Hebius_viperinum	Amphiesma_viperinum	Xenochrophis_viperinus	Hebius_viperinus
Hebius_celebicum	Amphiesma_celebicum	Styporhynchus_celebicus	Hebius_celebicus
Herpetoreas_burbrinki	Herpetoreas_burbrinki
Opisthotropis_balteata	Liparophis_bedoti	Opisthotropis_balteata	Opisthotropis_multicinctata	Trimerodytes_balteatus
Opisthotropis_rugosa	Lepidognathus_rugosus	Opisthotropis_rugosa
Opisthotropis_tamdaoensis	Opisthotropis_tamdaoensis
Opisthotropis_kikuzatoi	Eurypholis_kikuzatoi	Liopeltis_kikuzatoi	Opheodrys_kikuzatoi	Opisthotropis_kikuzatoi
Opisthotropis_boonsongi	Opisthotropis_boonsongi	Parahelicops_boonsongi	Isanophis_boonsongi
Opisthotropis_daovantieni	Opisthotropis_daovantieni
Opisthotropis_cucae	Opisthotropis_cucae
Opisthotropis_maculosa	Opisthotropis_maculosa
Opisthotropis_guangxiensis	Opisthotropis_yaoshanensis	Opisthotropis_guangxiensis
Opisthotropis_atra	Opisthotropis_ater	Opisthotropis_atra
Thamnophis_sauritus	Coluber_saurita	Eutaenia_sackenii	Prymnomiodon_chalceus	Thamnophis_sauritus_nitae	Thamnophis_sauritus_septentrionalis	Thamnophis_saurita
Thamnophis_angustirostris	Atomarchus_multimaculatus	Chilopoma_rufipunctatum	Eutaenia_angustirostris	Eutaenia_multimaculata	Nerodia_rufipunctatus	Thamnophis_angustirostris	Thamnophis_rufipunctatus
Thamnophis_valida	Natrix_valida_isabellae	Natrix_valida_thamnophisoides	Nerodia_valida	Regina_valida	Tropidonotus_celaeno	Tropidonotus_tephropleura	Thamnophis_validus
Virginia_striatula	Coluber_striatulus	Falconeria_bengalensis	Natris_striatulus	Virginia_inornata	Virginia_striatula	Haldea_striatula
Seminatrix_pygaea	Contia_pygaea	Seminatrix_pygaea	Liodytes_pygaea
Regina_rigida	Coluber_rigidus	Natrix_rigida	Natrix_rigida_deltae	Natrix_rigida_sinicola	Regina_rigida	Liodytes_rigida
Regina_alleni	Helicops_alleni	Regina_alleni	Liodytes_alleni
Hologerrhum_dermali	Hologerrhum_dermali
Sinonatrix_aequifasciata	Natrix_aequifasciata	Sinonatrix_aequifasciata	Sinonatrix_aquaefasciata	Trimerodytes_aequifasciatus
Sinonatrix_yunnanensis	Sinonatrix_yunnanensis	Trimerodytes_yunnanensis
Sinonatrix_annularis	Natrix_annularis	Sinonatrix_annularis	Tropidonotus_annularis	Tropidonotus_chinensis	Tropidonotus_habereri	Tropidonotus_semifasciatus	Trimerodytes_annularis
Sinonatrix_percarinata	Natrix_suriki	Sinonatrix_percarinata	Sinonatrix_percarinata_percarinata	Trimerodytes_percarinata_suriki	Tropidonotus_percarinatus	Trimerodytes_percarinatus
Aspidura_deraniyagalae	Aspidura_deraniyagalae
Aspidura_copei	Aspidura_copii	Aspidura_copei
Aspidura_drummondhayi	Aspidura_drummondhayi
Poecilopholis_cameronensis	Poecilopholis_cameronensis
Atractaspis_battersbyi	Atractaspis_battersbyi
Atractaspis_phillipsi	Atractaspis_phillipsi
Atractaspis_magrettii	Atractaspis_magrettii
Xenocalamus_michellii	Xenocalamus_michelli	Xenocalamus_michelli
Amblyodipsas_rodhaini	Rhinocalamus_rodhaini	Amblyodipsas_rodhaini
Amblyodipsas_katangensis	Amblyodipsas_katengensis_ionidesi	Amblyodipsas_katengensis_ionidesi	Amblyodipsas_katangensis
Aparallactus_moeruensis	Aparallactus_moeruensis
Aparallactus_nigriceps	Eucritus_atrocephalus	Uriechis_nigriceps	Aparallactus_nigriceps
Polemon_gracilis	Elapocalamus_gracilis	Polemon_gracilis
Polemon_griseiceps	Miodon_griseiceps	Polemon_griseiceps
Gonionotophis_laurenti	Gonionotophis_laurenti	Mehelya_laurenti	Mehelya_laurenti
Gonionotophis_gabouensis	Gonionotophis_gabouensis	Mehelya_gabouensis	Mehelya_gabouensis
Gonionotophis_egbensis	Gonionotophis_egbensis	Mehelya_egbensis	Mehelya_egbensis
Gonionotophis_chanleri	Gonionotophis_chanleri	Gonionotophis_unicolor	Mehelya_capensis_unicolor	Mehelya_chanleri	Mehelya_somaliensis_lonnberg	Simocephalus_chanleri	Simocephalus_poensis	Simocephalus_unicolor	Limaformosa_chanleri
Gonionotophis_guirali	Gonionotophis_guirali	Heterolepis_bicarinatus	Heterolepis_guirali	Mehelya_guirali	Simocephalus_baumanni	Limaformosa_guirali
Gonionotophis_nyassae	Gonionotophis_degrijsi	Gonionotophis_nyassae	Mehelya_nyassae	Simocephalus_nyassae	Gracililima_nyassae
Gonionotophis_savorgnani	Gonionotophis_savorgnani	Heterolepis_savorgnani	Mehelya_capensis_savorgnani	Mehelya_lamani	Simocephalus_butleri	Simocephalus_phyllopholis	Limaformosa_savorgnani
Gonionotophis_stenophthalmus	Gonionotophis_microps	Gonionotophis_stenophthalmus	Heterolepis_stenophthalmus	Mehelya_stenophthalmus
Gonionotophis_poensis	Gonionotophis_poensis	Heterolepis_bicarinatus	Heterolepis_poensis	Mehelya_poensis
Gonionotophis_vernayi	Gonionotophis_vernayi	Mehelya_vernayi	Limaformosa_vernayi
Gonionotophis_capensis	Gonionotophis_capensis	Gonionotophis_capensis_capensis	Heterolepis_capensis	Heterolepis_gueinzii	Mehelya_capensis	Limaformosa_capensis
Gonionotophis_crossi	Gonionotophis_crossi	Mehelya_crossi	Simocephalus_crossi	Limaformosa_crossi
Boaedon_maculatus	Lamprophis_maculatus	Boaedon_maculatus
Chamaelycus_christyi	Chamaelycus_christyi
Chamaelycus_werneri	Alopecion_fasciatum	Chamaelycus_werneri	Lycophidium_werneri	Chamaelycus_fasciatus
Chamaelycus_parkeri	Oophilositum_parkeri	Chamaelycus_parkeri
Lycodonomorphus_subtaeniatus	Lycodonomorphus_upembae	Lycodonomorphus_subtaeniatus
Pseudoboodon_sandfordorum	Pseudoboodon_sandfordorum
Lycophidion_pembanum	Lycophidion_capense_pembanum	Lycophidion_pembanum
Lycophidion_meleagris	Lycophidion_meleagre
Lycophidion_hellmichi	Lycophidion_hellmichi
Lycophidion_nanus	Cryptolycus_nanus	Lycophidion_nanum
Rhagerhis_moilensis	Coelopeltis_cordofanensis	Coelopeltis_moilensis	Coelopeltis_producta	Coluber_moilensis	Rhagerhis_moilensis	Rhamphiophis_maradiensis	Rhamphiophis_septentrionalis	Scutophis_moilensis	Malpolon_moilensis
Psammophis_phillipsi	Coluber_phillipsii	Psammophis_irregularis	Psammophis_notosticta	Psammophis_phillipsii
Psammophis_occidentalis	Psammophis_occidentalis	Psammophis_sibilans_mossambica	Psammophis_sibilans_occidentalis	Psammophis_sibilans_intermedius	Psammophis_sibilans_mossambica	Psammophis_sibilans_occidentalis	Psammophis_thomasi	Psammophis_mossambicus
Psammophylax_acutus	Psammophis_acutus	Psammophylax_acutus	Rhamphiophis_acutus_jappi	Rhamphiophis_acutus_wittei	Kladirostratus_acutus
Compsophis_fatsibe	Geodipsas_fatsibe	Compsophis_fatsibe
Compsophis_vinckei	Geodipsas_vinckei	Compsophis_vinckei
Thamnosophis_mavotenda	Thamnosophis_mavotenda
Liopholidophis_oligolepis	Liopholidophis_oligolepis
Liopholidophis_baderi	Liopholidophis_baderi
Pseudoxyrhopus_kely	Pseudoxyrhopus_kely
Pseudoxyrhopus_ankafinaensis	Pseudoxyrhopus_ankafinaensis
Pseudoxyrhopus_analabe	Pseudoxyrhopus_analabe	Pseudoxyrhopus_analabe
Liophidium_pattoni	Liophidium_pattoni
Liophidium_maintikibo	Liophidium_maintikibo
Ithycyphus_blanci	Ithycyphus_blanci
Langaha_alluaudi	Langaha_alluaudi
Phisalixella_tulearensis	Stenophis_tulearensis	Phisalixella_tulearensis
Phisalixella_iarakaensis	Stenophis_iarakaensis	Phisalixella_iarakaensis
Lycodryas_cococola	Lycodryas_cococola
Lycodryas_inornatus	Stenophis_inornatus	Lycodryas_inornatus
Madagascarophis_fuchsi	Madagascarophis_fuchsi
Brygophis_coulangesi	Perinetia_coulangesi	Brygophis_coulangesi
Calliophis_beddomei	Maticora_beddomei	Calliophis_beddomei
Micrurus_catamayensis	Micrurus_catamayensis
Micrurus_renjifoi	Leptomicrurus_renjifoi	Micrurus_renjifoi
Micrurus_oligoanellatus	Micrurus_oligoanellatus
Micrurus_scutiventris	Elaps_scutiventris	Leptomicrurus_schmidti	Leptomicrurus_scutiventris	Micrurus_karlschmidti	Micrurus_scutiventris
Micrurus_meridensis	Micrurus_dissoleucus_meridensis	Micrurus_meridensis
Micrurus_tamaulipensis	Elaps_fitzingeri	Elaps_tenere	Micrurus_fitzingeri_fitzingeri	Micrurus_fitzingeri_microgalbineus	Micrurus_fulvius_fitzingeri	Micrurus_fulvius_maculatus	Micrurus_fulvius_tener	Micrurus_tamaulipensis	Micrurus_tener
Micrurus_pacaraimae	Micrurus_pacaraimae
Thalassophis_anomalus	Thalassophina_anomala	Thalassophis_anomala	Hydrophis_anomalus
Naja_crawshayi
Elapsoidea_chelazziorum	Elapsoidea_chelazziorum
Elapsoidea_broadleyi	Elapsoidea_broadleyi
Kolpophis_annandalei	Distira_annandalei	Kolpophis_annandalei	Lapemis_annandalei	Hydrophis_annandalei
Hydrophis_bituberculatus	Aturia_bituberculata	Chitulia_bituberculata	Distira_bituberculatus	Hydrophis_cyanocinctus	Lioselasma_bituberculatus	Hydrophis_bituberculatus
Hydrophis_hendersoni	Distira_hendersoni	Hydrophis_hendersoni
Emydocephalus_szczerbaki	Emydocephalus_szczerbaki
Vermicella_calonotus	Furina_calonotos	Furina_calonotus	Neelaps_caledonicus	Neelaps_calonotos	Neelaps_neocaledonicus	Simoselaps_calonotos	Simoselaps_calonotus	Vermicella_calonotus	Neelaps_calonotus
Toxicocalamus_grandis	Apistocalamus_grandis	Toxicocalamus_grandis
Toxicocalamus_buergersi	Ultrocalamus_buergersi	Ultrocalamus_burgersi	Toxicocalamus_buergersi
Toxicocalamus_spilolepidotus	Toxicocalamus_spilolepidotus
Simoselaps_bimaculatus	Furina_bimaculata	Simoselaps_bimaculatus	Neelaps_bimaculatus
Parasuta_dwyeri	Denisonia_dwyeri	Parasuta_dwyeri	Suta_spectabilis_dwyeri	Suta_dwyeri
Parasuta_gouldii	Denisonia_gouldii	Denisonia_spectabilis_nullarbor	Elaps_gouldii	Parasuta_gouldii	Parasuta_spectabilis_bushi	Parasuta_spectabilis_nullarbor	Rhinoplocephalus_spectabilis_bushi	Suta_spectabilis_bushi	Suta_spectabilis_nullarbor	Unechis_gouldii	Suta_gouldii
Parasuta_nigriceps	Denisonia_nigriceps	Denisonia_nigrostriata_brevicauda	Hoplocephalus_nigriceps	Parasuta_nigriceps	Rhinoplocephalus_nigriceps	Unechis_brevicaudus	Unechis_nigriceps	Suta_nigriceps
Parasuta_monachus	Denisonia_monachus	Parasuta_monachus	Rhinoplocephalus_monachus	Suta_monachus	Unechis_monachus	Suta_monachus
Parasuta_spectabilis	Hoplocephalus_spectabilis	Parasuta_spectabilis	Parasuta_spectabilis_spectabilis	Rhinoplocephalus_spectabilis	Suta_spectabilis	Suta_spectabilis_spectabilis	Unechis_spectabilis	Suta_spectabilis
Parasuta_flagellum	Cryptophis_flagellum	Denisonia_flagellum	Hoplocephalus_flagellum	Parasuta_flagellum	Rhinoplocephalus_flagellum	Unechis_flagellum	Suta_flagellum
Simoselaps_warro	Brachyurophis_warro	Cacophis_warro	Simoselaps_warro	Antaioserpens_warro
Laticauda_schistorhynchus	Laticauda_semifasciata_schistorhynchus	Platurus_schistorhynchus	Pseudolaticauda_schistorhynchus	Laticauda_schistorhyncha
Calliophis_bivirgata	Calliophis_bivigrata	Doliophis_bivirgatus	Elaps_bivirgatus	Elaps_flaviceps	Elaps_tetrataenia	Calliophis_bivirgatus
Micrelaps_boettgeri	Elaposchema_vaillanti	Micrelaps_boettgeri	Micrelaps_nigriceps	Rhinocalamus_meleagris	Micrelaps_vaillanti
Micrelaps_tchernovi	Micrelaps_tchernovi	Micrelaps_muelleri
Calamophis_sharonbrooksae	Calamophis_sharonbrooksae
Calamophis_jobiensis	Brachyorrhos_jobiensis	Calamophis_jobiensis
Calamophis_katesandersae	Calamophis_katesandersae
Karnsophis_siantaris	Karnsophis_siantaris
Raclitia_indica	Enhydris_indica	Hypsirhina_indica	Raclitia_indica
Kualatahan_pahangensis	Enhydris_pahangensis	Kualatahan_pahangensis
Heurnia_ventromaculata	Heurnia_ventromaculata
Homalopsis_hardwickii	Homalopsis_hardwickii
Gyiophis_maculosa	Enhydris_maculosa	Hypsirhina_blanfordii	Hypsirhina_maculata	Hypsirhina_maculosa	Gyiophis_maculosus
Myron_karnsi	Myron_karnsi
Homalophis_gyii	Enhydris_gyii	Homalophis_gyii
Enhydris_innominata	Hypsirhina_innominata	Enhydris_innominata
Brachyorrhos_gastrotaenius	Oxyorrhos_fusiformis	Rabdion_gastrotaenia	Brachyorrhos_gastrotaenius
Trimeresurus_trigonocephalus	Coluber_capite-triangulatus	Coluber_trigonocephalus	Megaera_olivacea	Trigonocephalus_sagittiformis	Trimeresurus_trigonocephalus	Vipera_trigonocephala	Craspedocephalus_trigonocephalus
Trimeresurus_gramineus	Coluber_gramineus	Coluber_viridis	Lachesis_graminaeus	Trimeresurus_elegans	Trimeresurus_gramineus	Craspedocephalus_gramineus
Trimeresurus_malabaricus	Lachesis_anamallensis	Lachesis_coorgensis	Trigonocephalus_malabaricus	Trigonocephalus_wardii	Trimeresurus_anamallensis	Trimeresurus_malabaricus	Craspedocephalus_malabaricus
Trimeresurus_puniceus	Cophias_punicea	Trimeresurus_puniceus	Vipera_punicea	Craspedocephalus_puniceus
Trimeresurus_brongersmai	Trimeresurus_brongersmai
Trimeresurus_borneensis	Atropophis_borneensis	Trimeresurus_borneensis	Craspedocephalus_borneensis
Trimeresurus_wiroti	Trimeresurus_wiroti
Trimeresurus_rubeus	Cryptelytrops_rubeus	Trimeresurus_rubeus	Craspedocephalus_rubeus
Trimeresurus_toba	Popeia_toba	Trimeresurus_toba
Trimeresurus_buniana	Trimeresurus_buniana
Trimeresurus_sichuanensis	Sinovipera_sichuanensis	Trimeresurus_sichuanensis
Trimeresurus_andalasensis	Trimeresurus_andalasensis
Trimeresurus_strigatus	Protobothrops_strigatus	Trigonocephalus_neelgherriensis	Trimeresurus_strigatus
Trimeresurus_barati	Popeia_barati	Trimeresurus_popeorum_barati	Trimeresurus_barati
Trimeresurus_truongsonensis	Viridovipera_truongsonensis	Trimeresurus_truongsonensis
Trimeresurus_fucatus	Popeia_buniana	Popeia_fucatus	Popeia_sabahi	Trimeresurus_fucatus	Trimeresurus_popeorum_sabahi	Trimeresurus_sabahi
Gloydius_liupanensis	Gloydius_liupanensis
Gloydius_lijianlii	Gloydius_lijianlii	Gloydius_changdaoensis
Gloydius_saxatilis	Agkistrodon_halys_cognatus	Agkistrodon_halys_intermedius	Agkistrodon_saxatilis	Agkistrodon_shedaoensis_continentalis	Ancistrodon_saxatilis	Gloydius_intermedius_intermedius	Gloydius_saxatilis	Trigonocephalus_intermedius	Gloydius_intermedius
Gloydius_brevicaudus	Agkistrodon_blomhoffii_brevicaudus	Agkistrodon_blomhoffii_dubitatus	Agkistrodon_blomhoffii_siniticus	Ancistrodon_halys_brevicaudus	Gloydius_blomhoffii_brevicaudus	Gloydius_blomhoffii_dubitatus	Gloydius_brevicauda
Atropoides_occiduus	Atropoides_nummifer_occiduus	Atropoides_occiduus	Bothrops_affinis	Bothrops_nummifer_occiduus	Metlapilcoatlus_occiduus
Atropoides_indomitus	Atropoides_indomitus	Metlapilcoatlus_indomitus
Atropoides_olmec	Atropoides_olmec	Bothrops_olmec	Porthidium_olmec	Metlapilcoatlus_olmec
Atropoides_nummifer	Atropoides_nummifer	Atropoides_nummifer_nummifer	Atropos_nummifer	Bothrops_nummifer	Bothrops_nummifer_veraecrucis	Metlapilcoatlus_nummifer	Metlapilcoatlus_nummifer	Metlapilcoatlus_nummifer	Metlapilcoatlus_borealis
Atropoides_mexicanus	Atropoides_mexicanus	Atropoides_nummifer_mexicanus	Atropos_mexicanus	Bothriechis_nummifer_notata	Bothrops_nummifer_mexicanus	Metlapilcoatlus_mexicanus
Bothrops_lojanus	Bothriopsis_alticola	Bothrops_alticola	Bothrops_lojana	Bothrops_lojanus	Bothrocophias_lojanus
Bothrops_ayerbei	Bothrops_ayerbei
Bothrops_otavioi	Bothrops_otavioi
Bothrops_matogrossensis	Bothropoides_matogrossensis	Bothrops_neuwiedi_boliviana	Bothrops_neuwiedi_bolivianus	Bothrops_neuwiedi_mattogrossensis	Bothrops_mattogrossensis
Bothrops_taeniata	Bothriopsis_lichenosa	Bothriopsis_quadriscutatus	Bothriopsis_taeniata	Bothriopsis_taeniata_lichenosa	Bothrops_castelnaudi	Bothrops_lichenosa	Bothrops_taeniatus_lichenosa	Bothrops_taeniatus
Bothrops_bilineata	Bothriopsis_bilineata	Cophias_bilineatus	Cophias_bilineatus	Lachesis_bilineatus	Bothrops_bilineatus
Bothrops_marajoensis	Bothrops_marajoensis
Protobothrops_maolanensis	Protobothrops_maolanensis
Protobothrops_dabieshanensis	Protobothrops_dabieshanensis
Protobothrops_mangshanensis	Trimeresurus_mangshanensis	Zhaoermia_mangshanensis	Protobothrops_mangshanensis
Vipera_barani	Vipera_barani
Vipera_olguni	Pelias_darevskii_kumlutasi	Pelias_darevskii_uzumorum	Pelias_olguni	Vipera_kaznakovi_dinniki	Vipera_olguni	Vipera_renardi	Vipera_ursini_eriwanensis	Vipera_darevskii
Vipera_pontica
Vipera_magnifica	?_kaznakowi	Coluber_kaznakowi	Vipera_berus_ornata	Vipera_berus_ornata	Vipera_magnifica	Vipera_magnified	Vipera_pontica	Vipera_ursini_kaznakowi	Vipera_kaznakovi
Vipera_anatolica	Vipera_anatolica
Vipera_shemakhensis	Acridophaga_renardi_eriwanensis	Pelias_shemakhensis	Pelias_shemakhensis_kakhetiensis	Vipera_renadri	Vipera_shemakhensis	Vipera_ursini_erewanensis	Vipera_ursinii_ebneri	Vipera_ursinii_ebneri	Vipera_eriwanensis
Daboia_deserti	Macrovipera_deserti	Vipera_lebetina_deserti	Daboia_deserti
Montivipera_kuhrangica	Montivipera_kuhrangica
Macrovipera_schweizeri	Vipera_lebetina_schweizeri	Vipera_lebetina_siphnensis	Vipera_schweizeri	Macrovipera_schweizeri
Macrovipera_lebetina	Coluber_lebetinus	Daboia_lebetina_transmediterranea	Macrovipera_lebetina_cypriensis	Vipera_euphratica	Vipera_lebethina_errore	Vipera_lebetina	Vipera_lebetina_euphratica	Vipera_lebetina_transmediterranea	Vipera_lebetina_turanica	Vipera_mauritanica	Vipera_obtusa	Vipera_peilei	Vipera_xanthina	Macrovipera_lebetinus
Causus_rasmusseni	Causus_rasmusseni
Atheris_mabuensis	Atheris_mabuensis
Atheris_anisolepis	Atheris_laeviceps	Atheris_anisolepis
Atheris_acuminata	Atheris_acuminata
Atheris_subocularis	Atheris_subocularis
Atheris_katangensis	Atheris_katangensis
Atheris_matildae	Atheris_matildae
Bitis_inornata
Bitis_albanica	Bitis_albanica
Cerastes_boehmei	Cerastes_boehmei
Echis_hughesi	Echis_hughesi
Echis_jogeri	Echis_jogeri
Echis_megalocephalus	Echis_megalocephalus
Pareas_nigriceps	Pareas_nigriceps
Pareas_iwasakii	Amblycephalus_formosensis_iwasakii	Pareas_iwasakii
Achalinus_ater	Achalinus_ater	Achalinus_niger	Achalinus_ater
Achalinus_jinggangensis	Achalinopsis_jinggangensis	Achalinus_jinggangensis	Achalinus_jinggangensis
Parafimbrios_lao	Parafimbrios_lao
Stoliczkia_khasiensis	Stoliczkia_khasiensis
Stoliczkia_borneensis	Stoliczkaia_borneensis	Stoliczkia_borneensis
Bolyeria_multocarinata	Eryx_multocarinata	Tortrix_pseudo-eryx	Bolyeria_multocarinata
Xenophidion_schaeferi	Xenophidion_schaeferi_gunther	Xenophidion_schaeferi
Xenophidion_acanthognathus	Xenophidion_acanthognathus_gunther	Xenophidion_acanthognathus
Eryx_borrii	Eryx_borrii
Eryx_tataricus	Anguis_helluo	Anguis_miliaris	Boa_tatarica	Eryx_miliaris_incerta	Eryx_miliaris_rarus	Eryx_miliaris_tataricus	Eryx_miliaris_tritus	Eryx_miliaris_koslowi	Eryx_miliaris_roborowskii	Eryx_rickmersi	Eryx_speciosus	Eryx_tataricus	Eryx_tataricus_bogdanovi	Eryx_tataricus_speciosus	Eryx_miliaris
Corallus_cropanii	Xenoboa_cropanii	Corallus_cropanii
Corallus_hortulanus	Boa_ambleocephala	Boa_elegans	Boa_enhydris	Boa_enydris	Boa_hortulana	Boa_merremi	Boa_modesta	Boa_obtusiceps	Boa_salmonidia	Corallus_cooki	Corallus_enhydris	Corallus_enydris	Corallus_enydris_enydris	Corallus_hortulanus_enydris	Corallus_hortulanus_melanea	Corallus_maculatus	Corallus_obtusirostris	Vipera_bitis	Vipera_madarensis	Xiphosoma_dorsuale	Xiphosoma_ornatum	Xiphosoma_ruschenbergerii	Corallus_hortulana
Simalia_clastolepis	Morelia_clastolepis	Simalia_clastolepis
Simalia_oenpelliensis	Morelia_oenpelliensis	Python_oenpelliensis	Simalia_oenpelliensis	Nyctophilopython_oenpelliensis
Bothrochilus_huonensis	Bothrochilus_albertisii	Bothrochilus_biakensis	Bothrochilus_huonensis	Leiopython_albertisii_albertisii	Leiopython_albertisii_barkeri	Leiopython_biakensis	Leiopython_gracilis	Leiopython_huonensis	Liasis_alberitisii	Liasis_albertisii	Liasis_fuscus_albertisii	Lisalia_albertisi	Morelia_albertisii	Leiopython_albertisii
Bothrochilus_albertisii	Bothrochilus_albertisii	Bothrochilus_biakensis	Bothrochilus_huonensis	Leiopython_albertisii_albertisii	Leiopython_albertisii_barkeri	Leiopython_biakensis	Leiopython_gracilis	Leiopython_huonensis	Liasis_alberitisii	Liasis_albertisii	Liasis_fuscus_albertisii	Lisalia_albertisi	Morelia_albertisii	Leiopython_albertisii
Bothrochilus_biakensis	Bothrochilus_albertisii	Bothrochilus_biakensis	Bothrochilus_huonensis	Leiopython_albertisii_albertisii	Leiopython_albertisii_barkeri	Leiopython_biakensis	Leiopython_gracilis	Leiopython_huonensis	Liasis_alberitisii	Liasis_albertisii	Liasis_fuscus_albertisii	Lisalia_albertisi	Morelia_albertisii	Leiopython_albertisii
Bothrochilus_fredparkeri	Bothrochilus_bennettorum	Bothrochilus_fredparkeri	Bothrochilus_hoserae	Bothrochilus_meridionalis	Bothrochilus_montanus	Leiopython_albertisii_bennetti	Leiopython_bennettorum	Leiopython_hoserae	Leiopython_meridionalis	Leiopython_montanus	Leiopython_fredparkeri
Liasis_papuana	Liasis_maximus	Liasis_papuanus	Liasis_tornieri	Apodora_papuana
Leiopython_meridionalis	Bothrochilus_bennettorum	Bothrochilus_fredparkeri	Bothrochilus_hoserae	Bothrochilus_meridionalis	Bothrochilus_montanus	Leiopython_albertisii_bennetti	Leiopython_bennettorum	Leiopython_hoserae	Leiopython_meridionalis	Leiopython_montanus	Leiopython_fredparkeri
Leiopython_montanus	Bothrochilus_bennettorum	Bothrochilus_fredparkeri	Bothrochilus_hoserae	Bothrochilus_meridionalis	Bothrochilus_montanus	Leiopython_albertisii_bennetti	Leiopython_bennettorum	Leiopython_hoserae	Leiopython_meridionalis	Leiopython_montanus	Leiopython_fredparkeri
Antaresia_stimsoni	Antaresia_saxacola	Antaresia_saxacola_campbelli	Antaresia_stimsoni	Antaresia_stimsoni_campbelli	Antaresia_stimsoni_orientalis	Antaresia_stimsoni_stimsoni	Liasis_childreni	Liasis_maculosus	Liasis_stimsoni	Liasis_stimsoni_orientalis	Nardoa_gilbertii	Antaresia_childreni
Anomochilus_weberi	Anomalochilus_weberi	Anomochilus_weberi
Anomochilus_monticola	Anomochilus_monticola	Anomochilus_monticola
Cylindrophis_engkariensis	Cylindrophis_engkariensis
Cylindrophis_aruensis	Cylindrophis_aruensis
Cylindrophis_lineatus	Cylindrophis_lineatus	Cylindrophis_lineatus
Plectrurus_canaricus	Plectrurus_canaricus	Silybura_canarica	Pseudoplectrurus_canaricus
Brachyophidium_rhodogaster	Brachyophidium_rhodogaster	Teretrurus_rhodogaster
Uropeltis_phillipsi	Silybura_phillipsi	Uropeltis_phillipsi	Rhinophis_phillipsi
Uropeltis_melanogaster	Mytilia_melanogaster	Plectrurus_ceylonicus	Silybura_melanogaster	Uropeltis_melanogaster	Rhinophis_melanogaster
Rhinophis_tricolorata	Rhinophis_tricolorata_eror	Rhinophis_tricoloratus
Pseudotyphlops_philippinus	Pseudo-Typhlops_philippinus	Pseudotyphlops_philippinus	Pseudotyplops_philippinus	Uropeltis_pardalis	Uropeltis_philippinus	Uropeltis_philippinus	Uropeltis_saffraganus	Rhinophis_saffragamus
Rhinophis_porrectus	Rhinophis_porrectus
Rhinophis_goweri	Rhinophis_goweri
Rhinophis_fergusonianus	Rhinophis_fergusonianus
Uropeltis_macrorhyncha	Silybura_macrorhyncha	Uropeltis_macrorhyncha
Uropeltis_ceylanicus
Uropeltis_rubromaculatus	Silybura_rubromaculata	Uropeltis_rubromaculata
Uropeltis_broughami	Silybura_broughami	Silybura_levingii	Uropeltis_broughami
Uropeltis_smithi	Rhinophis_grandis	Silybura_grandis	Uropeltis_smithi	Uropeltis_grandis
Uropeltis_ruhunae	Silybura_nigra	Silybura_wood-masoni	Uropeltis_ruhunae	Uropeltis_woodmasoni
Platyplectrurus_trilineatus	Platyplectrurus_bilineatus	Plectrurus_trilineatus	Platyplectrurus_trilineatus
Tropidophis_parkeri	Tropidophis_caymanensis_parkeri	Tropidophis_parkeri
Tropidophis_xanthogaster	Tropidophis_xanthogaster
Tropidophis_jamaicensis	Tropidophis_haetianus_jamaicensis	Tropidophis_jamaicensis
Tropidophis_stejnegeri	Tropidophis_haetianus_stejnegeri	Tropidophis_pardalis_stejnegeri	Tropidophis_stejnegeri
Tropidophis_preciosus	Tropidophis_preciosus	Tropidophis_preciosus
Tropidophis_morenoi	Tropidophis_morenoi
Tropidophis_pilsbryi	Tropidophis_maculatus_pilsbryi	Tropidophis_pilsbryi_pilsbryi	Tropidophis_pilsbryi
Tropidophis_battersbyi	Tropidophis_battersbyi
Tropidophis_fuscus	Tropidophis_fuscus
Tropidophis_celiae	Tropidophis_celiae
Tropidophis_stullae	Tropidophis_haetianus_stullae	Tropidophis_maculatus_stullae	Tropidophis_stullae
Tropidophis_schwartzi	Tropidophis_caymanensis_schwartzi	Tropidophis_schwartzi
Anomalepis_mexicanus	Anomalepis_dentatus	Anomalepis_mexicanus	Anomalepis_mexicana
Liotyphlops_haadi	Liotyphlops_haadi
Liotyphlops_schubarti	Liotyphlops_schubarti
Liotyphlops_trefauti	Liotyphlops_trefauti
Madatyphlops_platyrhynchus	Madatyphlops_platyrhynchus	Typhlops_platyrhynchus	Afrotyphlops_platyrhynchus
Madatyphlops_madagascariensis	Typhlops_madagascariensis	Madatyphlops_madagascariensis
Madatyphlops_cuneirostris	Madatyphlops_cuneirostris	Typhlops_cuneirostris	Afrotyphlops_cuneirostris
Madatyphlops_leucocephalus	Madatyphlops_leucocephalus	Typhlops_leucocephalus	Rhinotyphlops_leucocephalus
Madatyphlops_calabresii	Madatyphlops_calabresii	Typhlops_calabresii	Typhlops_cuneirostris_calabresii	Afrotyphlops_calabresii
Argyrophis_trangensis	Asiatyphlops_trangensis	Typhlops_trangensis	Argyrophis_trangensis
Argyrophis_hypsobothrius	Indotyphlops_hypsobothrius	Typhlops_hypsobothrius	Argyrophis_hypsobothrius
Argyrophis_bothriorhynchus	Asiatyphlops_bothriorhynchus	Typhlops_bothriorhynchus	Argyrophis_bothriorhynchus
Argyrophis_fuscus	Asiatyphlops_fuscus	Ophthalmidion_fuscum	Typhlops_fuscus	Argyrophis_fuscus
Argyrophis_giadinhensis	Asiatyphlops_giadinhensis	Typhlops_giadinhensis	Argyrophis_giadinhensis
Argyrophis_klemmeri	Asiatyphlops_klemmeri	Typhlops_klemmeri	Argyrophis_klemmeri
Xerotyphlops_socotranus	Typhlops_socotranus	Xerotyphlops_socotranus
Xerotyphlops_etheridgei	Typhlops_etheridgei	Xerotyphlops_etheridgei
Xerotyphlops_wilsoni	Typhlops_wilsoni	Xerotyphlops_wilsoni
Cyclotyphlops_deharvengi	Cyclotyphlops_deharvengi
Ramphotyphlops_supranasalis	Typhlops_supranasalis	Ramphotyphlops_supranasalis
Ramphotyphlops_willeyi	Typhlina_willeyi	Typhlops_willeyi	Ramphotyphlops_willeyi
Ramphotyphlops_bipartitus	Typhlops_bipartitus	Ramphotyphlops_bipartitus
Ramphotyphlops_hatmaliyeb	Ramphotyphlops_hatmaliyeb
Ramphotyphlops_marxi	Typhlops_marxi	Ramphotyphlops_marxi
Ramphotyphlops_conradi	Typhlops_conradi	Ramphotyphlops_conradi
Ramphotyphlops_acuticaudus	Rhamphotyphlops_acuticaudus	Typhlops_acuticauda	Ramphotyphlops_acuticauda
Ramphotyphlops_lorenzi	Typhlops_lorenzi	Ramphotyphlops_lorenzi
Ramphotyphlops_similis	Typhlops_similis	Ramphotyphlops_similis
Acutotyphlops_banaorum	Acutotyphlops_banaorum
Anilios_nigricaudus	Anilios_nigricauda	Austrotyphlops_guentheri	Ramphotyphlops_guentheri	Typhlops_guentheri	Typhlops_nigricauda	Anilios_guentheri
Anilios_polygrammicus
Anilios_aspinus	Ramphotyphlops_aspina	Anilios_aspina
Anilios_leptosomus	Austrotyphlops_leptosomus	Ramphotyphlops_leptosomus	Anilios_leptosoma
Anilios_micrommus	Austrotyphlops_micrommus	Ramphotyphlops_micrommus	Anilios_micromma
Anilios_nigroterminatus	Anilios_nigroterminatus	Austrotyphlops_grypus	Ramphotyphlops_gryphus	Ramphotyphlops_grypus	Ramphotyphlops_nigroterminatus	Typhlina_grypha	Typhlops_grypus	Typhlops_kenti	Typhlops_nigroterminatus	Anilios_grypus
Lemuriatyphlops_microcephalus	Lemuriatyphlops_microcephalus	Typhlops_microcephalus	Madatyphlops_microcephalus
Lemuriatyphlops_domerguei	Lemuriatyphlops_domerguei	Typhlops_domergnei	Typhlops_domerguei	Madatyphlops_domerguei
Lemuriatyphlops_reuteri	Lemuriatyphlops_reuteri	Typhlops_lenzi	Typhlops_reuteri	Madatyphlops_reuteri
Indotyphlops_jerdoni	Typhlops_diversiceps	Typhlops_jerdoni	Typhlops_jerdonii_eror	Indotyphlops_jerdoni
Indotyphlops_malcolmi	Typhlops_malcolmi	Indotyphlops_malcolmi
Indotyphlops_filiformis	Typhlops_filiformis	Typhlops_fletcheri	Indotyphlops_filiformis
Indotyphlops_ahsanai	Typhlops_ahsanai	Indotyphlops_ahsanai
Indotyphlops_fletcheri	Typhlops_fletcheri	Indotyphlops_fletcheri
Indotyphlops_tenuicollis	Asiatyphlops_tenuicollis	Onychocephalus_tenuicollis	Typhlops_tenuicollis	Typhlops_theobaldanus	Typhlops_theobaldianus	Indotyphlops_tenuicollis
Indotyphlops_ozakiae	Indotyphlops_ozakiae	Ramphotyphlops_ozakiae	Typhlops_ozakiae	Ramphotyphlops_mollyozakiae
Indotyphlops_madgemintonae	Typhlops_madgemintonae	Typhlops_madgemintonai	Typhlops_madgemintonai_shermani	Typhlops_shermanai	Indotyphlops_madgemintonae
Indotyphlops_meszoelyi	Typhlops_meszoelyi	Indotyphlops_meszoelyi
Indotyphlops_pushpakumara
Indotyphlops_schmutzi	Typhlops_schmutzi	Indotyphlops_schmutzi
Indotyphlops_tenebrarum	Typhlops_tenebrarum	Indotyphlops_tenebrarum
Indotyphlops_khoratensis
Indotyphlops_violaceus	Typhlops_violaceus	Indotyphlops_violaceus
Indotyphlops_leucomelas	Asiatyphlops_leucomelas	Typhlops_leucomelas	Indotyphlops_leucomelas
Indotyphlops_lankaensis	Typhlops_lankaensis	Indotyphlops_lankaensis
Indotyphlops_veddae	Typhlops_veddae	Indotyphlops_veddae
Indotyphlops_exiguus	Typhlops_exignus	Typhlops_exiguus	Indotyphlops_exiguus
Malayotyphlops_ruficaudus	Anilios_ruficauda	Typhlops_dichromatus	Typhlops_jagori	Typhlops_jagorii	Typhlops_petersii	Typhlops_ruficaudus	Malayotyphlops_ruficauda
Malayotyphlops_koekkoeki	Typhlops_koekkoeki	Malayotyphlops_koekkoeki
Malayotyphlops_collaris	Typhlops_collaris	Malayotyphlops_collaris
Malayotyphlops_kraalii	Typhlops_kraalii	Malayotyphlops_kraalii
Rhinotyphlops_boylei	Typhlops_boylei	Rhinotyphlops_boylei
Letheobia_erythraea	Rhinotyphlops_erythraeus	Typhlops_erythraeus	Letheobia_erythraea
Letheobia_acutirostrata	Typhlops_acutirostratus	Typhlops_avakubae	Typhlops_caecus_pitmani	Letheobia_acutirostrata
Letheobia_rufescens	Rhinotyphlops_rufescens	Typhlops_rufescens	Typhlops_vrijdaghi	Typhlops_vryjdaghi	Letheobia_rufescens
Letheobia_debilis	Rhinotyphlops_debilis	Letheobia_debilis
Letheobia_leucosticta	Typhlops_leucostictus	Letheobia_leucosticta
Letheobia_simonii	Onychocephalus_simoni	Rhinotyphlops_simonii	Letheobia_simoni
Letheobia_wittei	Rhinotyphlops_wittei	Typhlops_vrijdaghi	Letheobia_wittei
Letheobia_largeni	Letheobia_largeni
Afrotyphlops_manni	Afrotyphlops_manni	Typhlops_manni	Letheobia_manni
Afrotyphlops_angeli	Afrotyphlops_angeli	Typhlops_angeli	Letheobia_angeli
Afrotyphlops_decorosus	Afrotyphlops_decorosus	Typhlops_decorosus	Letheobia_decorosus
Afrotyphlops_nanus	Afrotyphlops_nanus
Typhlops_anchaurus	Typhlops_anchaurus	Cubatyphlops_anchaurus
Typhlops_biminiensis	Typhlops_biminiensis	Typhlops_biminiensis_biminiensis	Typhlops_biminiensis_paradoxus	Cubatyphlops_biminiensis
Typhlops_contorhinus	Typhlops_contorhinus	Cubatyphlops_contorhinus
Typhlops_notorachius	Typhlops_notorachius	Cubatyphlops_notorachius
Typhlops_anousius	Typhlops_anousius	Cubatyphlops_anousius
Typhlops_satelles	Typhlops_satelles	Cubatyphlops_satelles
Typhlops_perimychus	Typhlops_perimychus	Cubatyphlops_perimychus
Typhlops_paradoxus	Typhlops_biminiensis_paradoxus	Typhlops_paradoxus	Cubatyphlops_paradoxus
Typhlops_monensis	Typhlops_monensis	Antillotyphlops_monensis
Typhlops_arator	Typhlops_arator	Cubatyphlops_arator
Typhlops_longissimus	Ophthalmidion_longissimum	Typhlops_longissimus	Indotyphlops_longissimus
Typhlops_caymanensis	Typhlops_caymanensis	Cubatyphlops_caymanensis
Typhlops_granti	Typhlops_granti	Antillotyphlops_granti
Typhlops_hypomethes	Typhlops_hypomethes	Antillotyphlops_hypomethes
Typhlops_zenkeri	Typhlops_vermis	Typhlops_zenkeri	Letheobia_zenkeri
Typhlops_platycephalus	Typhlops_platycephalus	Antillotyphlops_platycephalus
Typhlops_richardi	Typhlops_richardii	Antillotyphlops_richardi
Typhlops_naugus	Typhlops_naugus	Typhlops_richardii_naugus	Antillotyphlops_naugus
Typhlops_catapontus	Typhlops_catapontus	Typhlops_richardi_catapontus	Antillotyphlops_catapontus
Typhlops_guadeloupensis	Typhlops_dominicanus_guadeloupensis	Typhlops_guadeloupensis	Antillotyphlops_guadeloupensis
Typhlops_dominicanus	Typhlops_dominicanus	Typhlops_dominicanus_dominicanus	Antillotyphlops_dominicanus
Typhlops_disparilis	Anguis_lumbricalis	Typhlops_cubae	Typhlops_disparilis	Typhlops_lumbricalis
Typhlops_monastus	Typhlops_monastus	Typhlops_monastus_monastus	Antillotyphlops_monastus
Typhlops_geotomus	Typhlops_geotomus	Typhlops_monastus_geotomus	Antillotyphlops_geotomus
Typhlops_cariei	Typhlops_cariei	Madatyphlops_cariei
Typhlops_silus	Typhlops_silus
Typhlops_golyathi	Typhlops_golyathi	Cubatyphlops_golyathi
Typhlops_pachyrhinus	Typhlops_pachyrhinus
Typhlops_oxyrhinus	Typhlops_oxyrhinus
Typhlops_coecatus	Typhlops_caecatus	Typhlops_coecatus	Letheobia_coecatus
Typhlops_agoralionis	Typhlops_agoralionis
Typhlops_epactius	Typhlops_biminiensis_epactia	Typhlops_epactius	Cubatyphlops_epactius
Typhlops_sylleptor	Typhlops_sylleptor
Typhlops_leptolepis	Typhlops_leptolepis
Typhlops_annae	Typhlops_annae	Antillotyphlops_annae
Amerotyphlops_yonenagae	Typhlops_yonenagae	Amerotyphlops_yonenagae
Amerotyphlops_amoipira	Typhlops_amoipira	Amerotyphlops_amoipira
Xenotyphlops_grandidieri	Typhlops_grandidieri	Xenotyphlops_mocquardi	Xenotyphlops_grandidieri
Gerrhopilus_tindalli	Typhlops_tindalli	Gerrhopilus_tindalli
Gerrhopilus_mcdowelli	Typhlops_mcdowelli	Gerrhopilus_mcdowelli
Gerrhopilus_oligolepis	Typhlops_oligolepis	Gerrhopilus_oligolepis
Gerrhopilus_manilae	Gerrhopilus_manilae	Typhlops_manilae	Malayotyphlops_manilae
Gerrhopilus_thurstoni	Typhlops_hurstoni	Typhlops_thurstoni	Typhlops_walli	Gerrhopilus_thurstoni
Cathetorhinus_melanocephalus	Ramphotyphlops_melanocephalus	Cathetorhinus_melanocephalus
Myriopholis_wilsoni	Leptotyphlops_wilsoni	Myriopholis_wilsoni
Myriopholis_yemenicus	Leptotyphlops_yemenicus	Myriopholis_yemenica
Myriopholis_perreti	Leptotyphlops_perreti	Myriopholis_perreti
Myriopholis_natatrix	Glauconia_algeriensis	Glauconia_natatrix	Leptotyphlops_algeriensis	Leptotyphlops_macrorhynchus_algeriensis	Leptotyphlops_natatrix	Myriopholis_natatrix	Myriopholis_algeriensis
Leptotyphlops_nursii	Glauconia_nursii	Leptotyphlops_nursii	Myriopholis_nursii
Leptotyphlops_pungwensis	Leptotyphlops_pungwensis
Leptotyphlops_howelli	Leptotyphlops_howelli
Leptotyphlops_telloi	Leptotyphlops_telloi
Epacrophis_reticulatus	Glauconia_reticulata	Leptotyphlops_reticulatus	Epacrophis_reticulatus
Rhinoleptus_parkeri	Leptotyphlops_parkeri	Rhinoleptus_parkeri	Myriopholis_parkeri
Rhinoleptus_koniagui	Leptotyphlops_koniagui	Typhlops_koniagui	Rhinoleptus_koniagui
Mitophis_leptipileptus	Leptotyphlops_leptepileptus	Mitophis_leptepileptus
Rena_dissectus	Glauconia_dissecta	Leptotyphlops_dissectus	Leptotyphlops_dulcis_dissectus	Leptotyphlops_dulcis_supraocularis	Rena_dissecta
Rena_affinis	?_affinis	Glauconia_affinis	Leptotyphlops_affinis	Rena_affinis
Trilepida_guayaquilensis	Leptotyphlops_guayaquilensis	Tricheilostoma_guayaquilensis	Trilepida_guayaquilensis	Epictia_guayaquilensis
Trilepida_dimidiatum	Leptotyphlops_dimidiatus	Rena_dimidiata	Stenostoma_dimidiatum	Tricheilostoma_dimidiatum	Trilepida_dimidiata
Siagonodon_acutirostris	Siagonodon_acutirostris
Epictia_undecimstriata	Leptotyphlops_undecimstriatus	Typhlops_undecimstriatus	Epictia_undecimstriata
Epictia_melanurus	Leptotyphlops_melanurus	Epictia_melanura
Epictia_rubrolineata	Glauconia_albifrons_rubrolineata	Leptotyphlops_rubrolineatus	Epictia_rubrolineata
Epictia_collaris	Epictia_collaris	Leptotyphlops_collaris	Habrophallos_collaris
Epictia_unicolor	Glauconia_unicolor	Leptotyphlops_unicolor	Plauconia_unicolor	Epictia_unicolor
Epictia_nasalis	Epictia_nasalis	Leptotyphlops_albifrons_margaritae	Leptotyphlops_goudotii	Leptotyphlops_nasalis	Stenostoma_goudotii	Epictia_goudotii
Tricheilostoma_dissimilis	?_dissimilis	Leptotyphlops_dissimilis	Myriopholis_dissimilis	Stenostoma_dissimile	Tricheilostoma_dissimilis
Tricheilostoma_broadleyi	Guinea_broadleyi	Leptotyphlops_broadleyi	Tricheilostoma_broadleyi
Tricheilostoma_greenwelli	Guinea_greenwelli	Leptotyphlops_greenwelli	Tricheilostoma_greenwelli
Enyalioides_azulae	Enyalioides_azulae
Enyalioides_binzayedi	Enyalioides_binzayedi
Enyalioides_rudolfarndti	Enyalioides_rudolfarndti
Ctenosaura_defensor	Cachryx_annectens	Cachryx_defensor	Cachryx_erythromelas	Ctenosaura_annectens	Ctenosaura_defensor	Ctenosaura_erythromelas	Enyaliosaurus_defensor	Cachryx_defensor
Ctenosaura_praeocularis	Ctenosaura_praeocularis	Cyclura_quinquecarinata	Enyaliosaurus_quinquecarinatus	Ctenosaura_quinquecarinata
Ctenosaura_alfredschmidti	Ctenosaura_alfredschmidti	Cachryx_alfredschmidti
Conolophus_marthae	Conolophus_marthae
Stenocercus_squarrosus	Stenocercus_squarrosus
Stenocercus_arndti	Stenocercus_arndti
Stenocercus_chlorostictus	Stenocercus_chlorostictus
Stenocercus_dumerilii	Leiocephalus_dumerilii	Ophryoessoides_dumerilii	Stenocercus_dumerilii
Stenocercus_chinchaoensis	Stenocercus_chinchaoensis
Microlophus_stolzmanni	Microlophus_stolzmanni	Ophryoessoides_arenarius	Steironotus_arenarius	Stenocercus_arenarius	Tropidurus_arenarius	Tropidurus_stolzmanni	Tropidurus_tschudii	Microlophus_arenarius
Plica_kathleenae	Plica_kathleenae
Plica_pansticta	Tropidurus_panstictus	Plica_pansticta
Tropidurus_arenarius	Microlophus_stolzmanni	Ophryoessoides_arenarius	Steironotus_arenarius	Stenocercus_arenarius	Tropidurus_arenarius	Tropidurus_stolzmanni	Tropidurus_tschudii	Microlophus_arenarius
Tropidurus_mucujensis	Tropidurus_mucujensis
Leiosaurus_jaguaris	Leiosaurus_juguaris	Leiosaurus_jaguaris
Phymaturus_williamsi	Phymaturus_williamsi
Phymaturus_damasense	Phymaturus_damasense	Phymaturus_maulense
Phymaturus_castillensis	Centrura_patagonica_patagonica	Phymaturus_castillensis
Phymaturus_excelsus	Phymaturus_agilis	Phymaturus_excelsus	Phymaturus_spectabilis	Phymaturus_spurcus
Phymaturus_spectabilis	Phymaturus_agilis	Phymaturus_excelsus	Phymaturus_spectabilis	Phymaturus_spurcus
Phymaturus_desuetus	Phymaturus_desuetus
Phymaturus_bibronii	Oplurus_bibronii	Phymaturus_paihuanense	Phymaturus_bibronii
Phymaturus_felixi	Phymaturus_felixi
Phymaturus_videlai	Phymaturus_videlai
Phymaturus_yachanana	Phymaturus_yachanana
Liolaemus_morandae	Liolaemus_morandae	Liolaemus_morandae
Liolaemus_pantherinus	Liolaemus_pantherinus
Liolaemus_somuncurae	Liolaemus_kingi_somuncurae	Liolaemus_somuncurae
Liolaemus_uptoni	Liolaemus_uptoni
Liolaemus_tari	Liolaemus_tari
Liolaemus_tristis	Liolaemus_tristis
Liolaemus_salinicola	Liolaemus_salinicola
Liolaemus_erguetae	Liolaemus_islugensis_erguetae	Liolaemus_erguetae
Liolaemus_cranwelli	Pelusaurus_cranwelli	Liolaemus_cranwelli
Liolaemus_montanus	Liolaemus_montanus
Liolaemus_maldonadae	Liolaemus_maldonadae	Liolaemus_maldonadae
Liolaemus_manueli	Ctenoblepharys_audituvelatus	Liolaemus_manueli	Phrynosaura_audituvelata	Phrynosaura_manueli	Liolaemus_audituvelatus
Liolaemus_pyriphlogos	Liolaemus_pyriphlogos
Liolaemus_riodamas	Liolaemus_riodamas
Liolaemus_yatel	Liolaemus_yatel
Liolaemus_molinai	Liolaemus_molinai
Liolaemus_caparensis	Liolaemus_caparensis	Liolaemus_caparensis
Liolaemus_vallecurensis	Liolaemus_vallecurensis
Liolaemus_pipanaco	Liolaemus_pipanaco
Liolaemus_inti	Liolaemus_inti
Liolaemus_curis	Liolaemus_curis	Liolaemus_curis
Liolaemus_ceii	Liolaemus_ceii	Liolaemus_kriegi_muller	Liolaemus_kriegi
Liolaemus_disjunctus	Liolaemus_disjunctus
Liolaemus_filiorum	Liolaemus_filiorum
Liolaemus_lopezi	Liolaemus_lopezi
Liolaemus_heliodermis	Liolaemus_heliodermis
Liolaemus_montanezi	Liolaemus_montanezi
Liolaemus_huayra	Liolaemus_huayra
Liolaemus_griseus	Liolaemus_griseus
Liolaemus_chlorostictus	Liolaemus_chlorostictus
Liolaemus_yanalcu	Liolaemus_yanalcu
Liolaemus_ramonensis	Liolaemus_leopardinus_ramonensis	Liolaemus_ramonensis
Liolaemus_rabinoi	Ctenoblepharis_rabinoi	Liolaemus_rabinoi
Liolaemus_pagaburoi	Liolaemus_pagaburoi
Liolaemus_camarones	Eulaemus_affinis	Liolaemus_camarones	Liolaemus_melanops	Proctotretus_fitzingerii	Liolaemus_fitzingerii
Liolaemus_isabelae	Liolaemus_nigroventrolateralis	Liolaemus_isabelae
Liolaemus_orko	Liolaemus_orko
Liolaemus_melanopleurus	Proctotretus_melanopleurus	Liolaemus_melanopleurus
Liolaemus_porosus	Liolaemus_porosus
Liolaemus_exploratorum	Liolaemus_exploratorum
Liolaemus_vulcanus	Liolaemus_vulcanus
Liolaemus_ubaghsi	Liolaemus_ubaghsi
Liolaemus_tulkas	Liolaemus_tulkas
Liolaemus_pulcherrimus	Liolaemus_pulcherrimus
Leiocephalus_herminieri	Holotropis_herminieri	Leiocephalus_herminieri
Leiocephalus_anonymous	Leiocephalus_anonymous
Leiocephalus_etheridgei	Leiocephalus_etheridgei
Leiocephalus_partidus	Leiocephalus_partidus
Anolis_lamari	Dactyloa_lamari	Anolis_lamari
Anolis_poei	Anolis_poei
Anolis_otongae	Anolis_otongae
Anolis_carlostoddi	Dactyloa_carlostoddi	Phenacosaurus_carlostoddi	Anolis_carlostoddi
Anolis_propinquus	Dactyloa_propinqua	Anolis_propinquus
Anolis_philopunctatus	Anolis_boulengeri	Anolis_bullaris	Anolis_catenifer	Anolis_gracilis	Anolis_nasicus	Anolis_philopunctatus	Anolis_transfasciatus	Anolis_violaceus	Anolis_viridis	Anolis_viridissimus	Dactyloa_philopunctata	Dactyloa_punctata	Rhinosaurus_gracilis	Anolis_punctatus
Anolis_deltae	Dactyloa_deltae	Anolis_deltae
Anolis_chocorum	Anolis_chocorum	Dactyloa_purpurescens	Anolis_purpurescens
Anolis_bellipeniculus	Dactyloa_bellipeniculus	Phenacosaurus_bellipeniculus	Anolis_bellipeniculus
Anolis_coelestinus	Anolis_coelestinus	Deiroptyx_coelestina	Anolis_chlorocyanus
Anolis_sierramaestrae	Anolis_sierramaestrae
Anolis_gibbiceps	Anolis_gibbiceps
Anolis_ibague	Norops_ibague	Anolis_ibague
Anolis_rhombifer	Anolis_palpebrosus	Anolis_rhombifer	Norops_lemurinus	Anolis_lemurinus
Anolis_eewi	Anolis_eewi	Norops_planiceps	Anolis_planiceps
Anolis_birama	Norops_birama	Anolis_birama
Anolis_lemniscatus	Norops_lemniscatus	Anolis_lemniscatus
Anolis_williamsii	Anolis_cumingii	Anolis_heliactin	Anolis_jacobi	Anolis_kidderi	Anolis_longicauda	Anolis_sallaei	Anolis_williamsii	Norops_cumingii	Norops_sericeus	Anolis_sericeus
Anolis_rodriguezi	Anolis_acutirostris	Anolis_aureolus	Norops_rodriguezii	Anolis_rodriguezii
Anolis_delafuentei	Norops_delafuentei	Anolis_delafuentei
Anolis_ordinatus	Anolis_greyi	Anolis_ordinatus	Anolis_sagrae	Anolis_stejnegeri	Dactyloa_sagraei	Dracontura_catenata	Norops_sagrai	Norops_sagrei	Anolis_sagrei
Anolis_intermedius	Anolis_bourgeaei	Anolis_cortezi	Anolis_intermedius	Anolis_nannodes	Anolis_stuarti	Anolis_tessellatus	Anolis_ustus_verae-pacis	Anolis_wiegmanni	Dactyloa_laeviventris	Norops_laeviventris	Anolis_laeviventris
Anolis_impetigosus	Anolis_impetigosus
Anolis_scapularis	Anolis_bocourtii	Anolis_brumetii	Anolis_fusco-auratus	Anolis_fuscoauratus_kugleri	Anolis_klugeri	Anolis_kugleri	Anolis_scapularis	Anolis_viridiaeneus	Draconura_fuscoauratus	Noprops_scapularis	Norops_fuscoauratus	Anolis_fuscoauratus
Anolis_wattsi	Anolis_alter	Anolis_wattsii
Anolis_whitemani	Anolis_cybotes_saxatilis	Anolis_whitemani	Anolis_whitemani_lapidosus	Audantia_saxatilis	Audantia_whitemani	Anolis_saxatilis
Anolis_haetianus	Anolis_haetianus	Anolis_riisei	Audantia_cybotes	Ctenonotus_cybotes	Anolis_cybotes
Anolis_breslini	Anolis_whitemani_breslini	Audantia_breslini	Anolis_breslini
Anolis_incredulus	Anolis_incredulus
Anolis_maynardi	Anolis_maynardii
Anolis_oporinus	Anolis_oporinus
Anolis_toldo	Anolis_toldo
Urosaurus_nigricaudus	Urosaurus_microscutatus	Uta_microscutata	Uta_nigricaudus	Uta_parviscutata	Urosaurus_nigricauda
Urosaurus_irregularis	Phymatolepis_bicarinatus	Phymatolepis_irregularis	Urosaurus_irregularis	Uta_anonymorpha	Uta_nelsoni	Uta_tuberculata	Urosaurus_bicarinatus
Sceloporus_caeruleus	Sceloporus_caeruleus
Sceloporus_becki	Sceloporus_occidentalis_becki	Sceloporus_becki
Phrynosoma_wigginsi	Phrynosoma_jamesi	Phrynosoma_wigginsi	Phrynosoma_cerroense
Hypsilurus_spinipes	Goniocephalus_spinipes	Hypsilurus_spinipes	Lophyrus_spinipes	Lophosaurus_spinipes
Hypsilurus_dilophus	Calotes_megapogon	Hypsilurus_dilophus	Lophyrus_dilophus	Tiaris_megapogon	Lophosaurus_dilophus
Hypsilurus_boydii	Goniocephalus_boydii	Hypsilurus_boydii	Tiaris_boydii	Lophosaurus_boydii
Hypsilurus_tenuicephalus	Hypsilurus_tenuicephalus
Hypsilurus_ornatus	Hypsilurus_ornatus
Diporiphora_arnhemica	Diporiphora_arnhemica
Lophognathus_longirostris	Lophognathus_longirostris	Physignathus_eraduensis	Physignathus_longirostris_quattuorfasciatus	Gowidon_longirostris
Lophognathus_maculilabris	Lophognathus_maculilabris
Lophognathus_burnsi	Lophognathus_burnsi	Amphibolurus_burnsi
Thaumatorhynchus_brooksi	Thaumatorhynchus_brooksi	Harpesaurus_brooksi
Oriocalotes_paulus	Calotes_minor	Oriocalotes_minor	Oriocalotes_paulus	Calotes_paulus
Coryphophylax_brevicaudus	Coryphophylax_brevicauda
Bronchocela_orlovi	Bronchocela_orlovi
Gonocephalus_mjobergi	Gonocephalus_mjobergi
Pseudocophotis_sumatrana	Calotes_aberrans	Calotes_nasicornis	Cophotis_sumatrana	Pseudocalotes_sumatrana	Pseudocophotis_sumatrana
Pseudocophotis_kontumensis	Pseudocophotis_kontumensis
Phoxophrys_spiniceps	Phoxophrys_spiniceps	Pelturagonia_spiniceps
Phoxophrys_nigrilabris	Otocryptis_nigrilabris	Phoxophrys_nigrilabris	Pelturagonia_nigrilabris
Phoxophrys_cephalum	Pelturagonia_cephalum	Phoxophrys_cephalum	Pelturagonia_cephalum
Phoxophrys_borneensis	Phoxophrys_borneensis	Pelturagonia_borneensis
Calotes_bhutanensis	Calotes_bhutanensis
Calotes_nigriplicatus	Calotes_nigriplicatus
Calotes_rouxii	Calotes_rouxii	Monilesaurus_rouxii
Calotes_ellioti	Bronchocela_indica	Calotes_ellioti	Calotes_ellioti_amarambalamensis	Monilesaurus_ellioti
Calotes_manamendrai	Calotes_manamendrai	Calotes_manamendrai
Calotes_aurantolabium	Calotes_andamanensis	Calotes_aurantolabium	Microauris_aurantolabium
Acanthosaura_brachypoda	Acanthosaura_brachypoda
Gonocephalus_robinsonii	Gonyocephalus_robinsonii	Malayodracon_robinsonii
Japalura_yulongensis	Japalura_flaviceps	Japalura_yulongensis	Diploderma_yulongense
Japalura_makii	Japalura_makii	Diploderma_makii
Japalura_splendida	Japalura_splendida	Diploderma_splendidum
Japalura_planidorsata	Japalura_planidorsata	Cristidorsa_planidorsata
Japalura_luei	Japalura_luei	Diploderma_luei
Japalura_flaviceps
Japalura_brevipes	Japalura_brevipes	Diploderma_brevipes
Japalura_zhaoermii	Japalura_zhaoermii	Diploderma_zhaoermii
Japalura_chapaensis	Japalura_chapaensis	Japalura_swinhonis_chapaensis	Diploderma_chapaense
Japalura_otai	Japalura_otai	Cristidorsa_otai
Japalura_fasciata	Japalura_fasciata	Japalura_szechwanensis	Diploderma_fasciatum
Japalura_yunnanensis
Japalura_polygonata	Diploderma_polygonata_ishigakiense	Diploderma_polygonata_xanthostomum	Japalura_polygonata	Japalura_polygonata_donan	Japalura_polygonata_ishigakiensis	Japalura_polygonata_miyakensis	Japalura_polygonata_xanthostoma	Diploderma_polygonatum
Japalura_varcoae	Acanthosaura_varcoae	Japalura_varcoae	Diploderma_varcoae
Japalura_batangensis	Diploderma_batangensis	Japalura_batangensis	Diploderma_batangense
Japalura_brevicauda	Japalura_brevicauda	Japalura_flaviceps	Japalura_yunnanensis	Diploderma_brevicauda
Japalura_hamptoni	Japalura_hamptoni	Diploderma_hamptoni
Japalura_grahami	Japalura_grahami	Phoxophrys_grahami	Diploderma_grahami
Japalura_dymondi	Acanthosaura_dymondi	Japalura_dymondi	Diploderma_dymondi
Japalura_swinhonis	Japalura_mitsukurii	Japalura_mitsukurii_formosensis	Japalura_mitsukurii_mitsukurii	Japalura_polyhonata_mitsukurii	Japalura_swinhoei	Japalura_swinhonis	Japalura_swinhonis	Japalura_swinhonis_formosensis	Japalura_swinhonis_mitsukurii	Japalura_yunnanensis_popei	Diploderma_swinhonis
Japalura_micangshanensis	Diploderma_micangshanensis	Japalura_micangshanensis	Japalura_ningjiangensis	Diploderma_micangshanense
Pseudocalotes_dringi	Pseudocalotes_dringi
Pseudocalotes_rhammanotus	Pseudocalotes_rhammanotus
Pseudocalotes_guttalineatus	Pseudocalotes_guttalineatus
Pseudocalotes_saravacensis	Pseudocalotes_saravacensis
Pseudocalotes_larutensis	Pseudocalotes_larutensis
Pseudocalotes_austeniana	Mictopholis_austeniana	Pseudocalotes_austeniana	Salea_austeniana	Japalura_austeniana
Pseudocalotes_flavigula	Calotes_flavigula	Pseudocalotes_flavigula
Harpesaurus_modiglianii	Harpesaurus_modiglianii
Harpesaurus_beccarii	Harpesaurus_beccarii
Harpesaurus_ensicauda	Harpesaurus_ensicauda
Harpesaurus_tricinctus	Arpephorus_tricinctus	Harpesaurus_tricinctus
Salea_gularis	Salea_gularis	Salea_gularis
Complicitus_nigrigularis	Calotes_nigrigularis	Complicitus_nigrigularis
Sitana_schleichi	Sitana_schleichi	Sitana_schleichi
Sitana_fusca	Sitana_fusca
Draco_iskandari	Draco_iskandari
Draco_bourouniensis	Draco_amboinensis	Draco_bourouniensis	Draco_buruensis	Draco_daudinii	Draco_lineatus_ochropterus	Draco_ochropterus	Draco_reinwardtii	Draco_toxopei	Dracunculus_personatus	Draco_lineatus
Draco_supriatnai	Draco_supriatnai
Japalura_dasi	Oriotiaris_dasi	Japalura_dasi
Trapelus_schmitzi	Trapelus_schmitzi
Trapelus_jayakari	Agama_flavimaculata	Agama_jayakari	Trapelus_flavimaculatus	Trapelus_jayakari	Trapelus_flavimaculatus
Xenagama_batillifera	Uromastix_batilliferus	Xenagama_batillifera
Agama_sylvana	Agama_agama_africana	Agama_savattieri	Agama_sylvanus	Oreodeira_gracilipes	Tropidolepis_africanus	Agama_africana
Agama_hartmanni	Agama_cornii	Agama_doriae	Agama_hartmanni
Agama_bottegi	Agama_bottegi
Agama_cristata	Agama_cristata
Phrynocephalus_raddei	Phrynocephalus_raddei_bilkewitschi	Phrynocephalus_raddei_boettgeri	Phrynocephalus_raddei_zardunyi	Phrynocephalus_raddei
Phrynocephalus_ahvazicus	Phrynocephalus_ahvazicus
Phrynocephalus_erythrurus	Phrynocephalus_erythrurus
Laudakia_papenfussi	Laudakia_papenfussi
Laudakia_dayana	Barycephalus_sykesii	Stellio_dayanus	Laudakia_dayana
Laudakia_wui	Laudakia_wui
Brachysaura_minor	Acanthosaura_minor	Agama_minor	Brachysaura_minor	Brachysaura_ornata	Charasia_ornata	Laudakia_minor	Calotes_minor
Paralaudakia_bochariensis	Agama_chernovi	Laudakia_bochariensis	Stellio_bochariensis	Paralaudakia_bochariensis
Paralaudakia_badakhshana	Agama_badakhshana	Paralaudakia_badakhshana
Uromastyx_alfredschmidti	Uromastyx_alfredschmidti	Uromastyx_alfredschmidti
Uromastyx_occidentalis	Uromastyx_occidentalis
Uromastyx_yemenensis	Uromastyx_yemenensis
Uromastyx_shobraki	Uromastyx_shobraki	Uromastyx_yemenensis_shobraki	Uromastyx_shobraki
Palleon_lolontany	Brookesia_lolontany	Palleon_lolontany
Brookesia_karchei	Brookesia_karchei
Brookesia_bekolosy	Brookesia_bekolosy
Brookesia_lambertoni	Brookesia_lambertoni
Rhampholeon_beraduccii	Rhampholeon_beraduccii
Rhampholeon_maspictus	Rhampholeon_maspictus
Furcifer_tuzetae	Chamaeleo_tutzetae	Furcifer_tuzetae
Calumma_peyrierasi	Chamaeleo_peyrierasi	Calumma_peyrierasi
Calumma_jejy	Calumma_jejy
Calumma_vatosoa	Calumma_vatosoa
Calumma_hafahafa	Calumma_hafahafa
Calumma_tsycorne	Calumma_tsycorne
Calumma_vencesi	Calumma_vencesi
Calumma_tarzan	Calumma_tarzan
Calumma_andringitraense	Chamaeleo_gastrotaenia_andringitraensis	Calumma_andringitraense
Trioceros_perreti	Chamaeleo_wiedersheimi_perreti	Trioceros_wiedersheimi_perreti	Trioceros_perreti
Trioceros_eisentrauti	Chamaeleo_eisentrauti	Chamaeleo_quadricornis	Chamaeleo_quadricornis_eisentrauti	Chamaeleo_quadricornis_gracilior	Chamaeleon_quadricornis	Trioceros_eisentrauti	Trioceros_quadricornis
Trioceros_ntunte	Chamaeleo_ntunte	Trioceros_ntunte
Trioceros_schoutedeni	Chamaeleo_bitaeniatus_schoutedeni	Chamaeleo_schoutedeni	Trioceros_schoutedeni
Trioceros_nyirit	Trioceros_nyirit
Kinyongia_asheorum	Kinyongia_asheorum
Kinyongia_vanheygeni	Kinyongia_vanheygeni
Anguis_incomptus	Anguis_incomptus	Ophisaurus_incomptus
Dopasia_hainanensis	Ophisaurus_hainanensis	Dopasia_hainanensis
Dopasia_wegneri	Ophisaurus_wegneri	Dopasia_wegneri
Ophisaurus_koellikeri	Hyalosaurus_koellikeri	Ophisaurus_koellikeri	Pseudopus_apus_ornata	Hyalosaurus_koellikeri
Abronia_fimbriata	Barissia_fimbriata	Gerrhonotus_auritus	Abronia_fimbriata
Mesaspis_monticola	Barisia_monticola	Gerrhonotus_alfaroi	Gerrhonotus_monticolus	Mesaspis_monticola	Abronia_monticola
Mesaspis_juarezi	Barisia_juarezi	Mesaspis_juarezi	Abronia_juarezi
Mesaspis_gadovii	Barisia_gadovii_levigata	Gerrhonotus_gadovii	Mesaspis_gadovii	Mesaspis_gadovii_levigata	Abronia_gadovii
Mesaspis_viridiflava	Gerrhonotus_bocourti	Gerrhonotus_viridiflavus	Mesaspis_viridiflava	Abronia_viridiflava
Mesaspis_antauges	Barisia_antauges	Gerrhonotus_modestus	Mesaspis_antauges	Pterogasterus_modestus	Abronia_antauges
Abronia_meledona	Abronia_meledona
Gerrhonotus_farri	Gerrhonotus_farri
Coloptychon_rhombifer	Coloptychon_rhombifer	Gerrhonotus_rhombifer	Gerrhonotus_rhombifer
Ophiodes_yacupoi	Ophiodes_yacupoi	Seps_fragilis	Ophiodes_fragilis
Diploglossus_garridoi	Diploglossus_garridoi
Celestus_carraui	Celestus_carraui	Diploglossus_carraui	Diploglossus_warreni	Celestus_warreni
Diploglossus_owenii	Diploglossus_owenii
Diploglossus_ingridae	Diploglossus_ingridae	Celestus_ingridae
Diploglossus_microcephalus
Diploglossus_microlepis	Diploglossus_microlepis	Microlepis_undulata	Tiliqua_microlepis	Diploglossus_microlepis
Diploglossus_legnotus	Diploglossus_legnotus	Celestus_legnotus
Celestus_adercus	Celestus_adercus
Celestus_bivittatus	Celestus_bivittatus	Diploglossus_bivittatus	Diploglossus_bivittatus
Celestus_scansorius	Celestus_scansorius	Diploglossus_scansorius
Celestus_montanus	Celestus_montanus	Diploglossus_montanus	Diploglossus_montanus
Xenosaurus_penai	Xenosaurus_penai_perez	Xenosaurus_penai
Xenosaurus_mendozai	Xenosaurus_mendozai
Varanus_reisingeri	Varanus_reisingeri
Varanus_obor	Varanus_obor
Varanus_zugorum	Varanus_zugorum
Varanus_finschi	Varanus_doreanus_finschi	Varanus_finschi
Varanus_macraei	Varanus_macraei_bohme	Varanus_macraei
Varanus_boehmei	Varanus_boehmei
Varanus_telenesetes	Varanus_prasinus	Varanus_telenesetes
Varanus_ornatus
Blanus_mariae	Amphisbaena_cinerea	Amphisbaena_cinerea	Amphisbaena_oxyura	Amphisbaena_reticulata	Blanus_mariae	Blanus_cinereus
Ancylocranium_somalicum	Anops_somalicus	Ancylocranium_somalicum
Baikia_africana	Baikia_africana
Dalophia_luluae	Monopeltis_luluae	Tomuropeltis_luluae	Dalophia_luluae
Dalophia_gigantea	Monopeltis_giganteus	Monopeltis_truncata	Tomuropeltis_gigantea	Dalophia_gigantea
Monopeltis_perplexus	Monopeltis_perplexus
Monopeltis_remaclei	Monopeltis_remaclei
Monopeltis_zambezensis	Monopeltis_zambezensis
Monopeltis_scalper	Lepidosternon_scalprum	Monopeltis_gerardi	Monopeltis_scalper_bulsi	Phractogonus_scalper	Monopeltis_scalper
Monopeltis_kabindae	Monopeltis_kabindae
Monopeltis_vanderysti	Monopeltis_lujae	Monopeltis_vanderysti_closei	Monopeltis_vanderysti_vilhenai	Monopeltis_vanderysti
Monopeltis_adercae	Monopeltis_adercae	Monopeltis_adercae
Monopeltis_welwitschii	Dalophia_welwitschii	Monopeltis_welwitschii	Dalophia_welwitschii
Loveridgea_phylofiniens	Amphisbaena_phylofiniens	Loveridgea_phylofiniens
Amphisbaena_lumbricalis	Amphisbaena_lumbricalis
Amphisbaena_trachura	Amphisbaena_heterozonata	Amphisbaena_mildei	Amphisbaena_trachura	Amphisbaena_darwinii
Amphisbaena_stejnegeri	Amphisbaena_stejnegeri
Amphisbaena_myersi	Amphisbaena_myersi
Amphisbaena_scutigerum	Amphisbaena_scutigera	Cephalopeltis_cuvieri	Cephalopeltis_scutigerua	Lepidosternon_hemprichii	Lepidosternon_scutigerum	Leposternon_scutigerum
Amphisbaena_leali	Amphisbaena_leali
Amphisbaena_heterozonata	Amphisbaena_heterozonata	Amphisbaena_mildei	Amphisbaena_trachura	Amphisbaena_darwinii
Amphisbaena_sanctaeritae	Amphisbaena_sanctaeritae
Amphisbaena_maximus	Amphisbaena_maximus	Leposternon_maximus	Leposternon_maximus
Amphisbaena_maranhensis	Amphisbaena_maranhensis
Amphisbaena_polystegum	Amphisbaena_polystegum	Lepidosternon_grayii	Lepidosternon_polystegum	Leposternon_polystegoides	Leposternon_polystegum
Amphisbaena_albocingulata	Amphisbaena_albocingulata
Amphisbaena_neglecta	Amphisbaena_neglecta
Amphisbaena_polygrammica	Amphisbaena_polygrammica
Amphisbaena_infraorbitale	Amphisbaena_infraorbitale	Lepidosternon_infraorbitale	Lepidosternon_rostratum	Leposternon_infraorbitale
Amphisbaena_microcephalum	Amphisbaena_microcephalum	Amphisbaena_punctata	Lepidosternon_boettgeri	Lepidosternon_carcani	Lepidosternon_crassum	Lepidosternon_guntheri	Lepidosternon_laticeps	Lepidosternon_maximiliani	Lepidosternon_petersi	Lepidosternon_pfefferi	Lepidosternon_phocaena	Lepidosternum_affine	Lepidosternum_borelli	Lepidosternum_boulengeri	Lepidosternum_camerani	Lepidosternum_latifrontale	Lepidosternum_onychocephalum	Lepidosternum_strauchi	Leposternon_microcephalum	Leposternon_microcephalum
Amphisbaena_bilabialatus	Anops_bilabialatus	Amphisbaena_bilabialata
Amphisbaena_darwini	Amphisbaena_heterozonata	Amphisbaena_mildei	Amphisbaena_trachura	Amphisbaena_darwinii
Amphisbaena_acrobeles	Anops_acrobeles	Amphisbaena_acrobeles
Amphisbaena_ibijara	Amphisbaena_ibijara
Amphisbaena_arda	Amphisbaena_arda
Amphisbaena_crisae	Amphisbaena_crisae
Amphisbaena_wuchereri	Amphisbaena_wuchereri	Lepidosternon_wuchereri	Lepidosternum_sinuosum	Leposternon_wuchereri	Leposternon_wuchereri
Amphisbaena_cegei	Amphisbaena_cegei
Amphisbaena_amazonica	Amphisbaena_amazonica	Amphisbaena_americana	Amphisbaena_bassleri	Amphisbaena_flava	Amphisbaena_magnifica	Amphisbaena_varia	Amphisbaena_vulgaris	Amphisbaena_fuliginosa
Amphisbaena_wiedi
Amphisbaena_kisteumacheri	Amphisbaena_kisteumacheri	Leposternon_kisteumacheri	Leposternon_kisteumacheri
Amphisbaena_borelli	Amphisbaena_borelli
Amphisbaena_kraoh	Bronia_kraoh	Amphisbaena_kraoh
Amphisbaena_saxosa	Bronia_saxosa	Amphisbaena_saxosa
Amphisbaena_cerradensis	Amphisbaena_cerradensis	Leposternon_cerradensis	Leposternon_cerradensis
Amphisbaena_persephone	Amphisbaena_persephone
Amphisbaena_octostegum	Amphisbaena_octostegum	Lepidosternon_octostegum	Leposternon_octostegum
Amphisbaena_carli	Amphisbaena_carli
Amphisbaena_arenaria	Amphisbaena_arenaria
Amphisbaena_tragorrhectes	Amphisbaena_tragorrhectes
Amphisbaena_caiari	Amphisbaena_caiari
Amphisbaena_bassleri	Amphisbaena_amazonica	Amphisbaena_americana	Amphisbaena_bassleri	Amphisbaena_flava	Amphisbaena_magnifica	Amphisbaena_varia	Amphisbaena_vulgaris	Amphisbaena_fuliginosa
Amphisbaena_supernumeraria	Amphisbaena_supernumeraria
Amphisbaena_varia	Amphisbaena_amazonica	Amphisbaena_americana	Amphisbaena_bassleri	Amphisbaena_flava	Amphisbaena_magnifica	Amphisbaena_varia	Amphisbaena_vulgaris	Amphisbaena_fuliginosa
Amphisbaena_rozei	Amphisbaena_rozei
Amphisbaena_bahiana	Cercolophia_bahiana	Amphisbaena_bahiana
Amphisbaena_uroxena	Amphisbaena_uroxena
Amphisbaena_mensae	Amphisbaena_mensae	Amphisbaena_talisiae
Amphisbaena_miringoera	Amphisbaena_miringoera
Cynisca_muelleri	Amphisbaena_muelleri	Amphisbaena_mulleri	Cynisca_muelleri
Cynisca_schaeferi	Chirindia_schaeferi	Cynisca_schaeferi
Cynisca_kigomensis	Cynisca_kigomensis
Cynisca_williamsi	Cynisca_williamsi
Cynisca_gansi	Cynisca_gansi
Cynisca_oligopholis	Amphisbaena_oligopholis	Cynisca_oligopholis
Cynisca_nigeriensis	Cynisca_nigeriensis
Cynisca_haugi	Amphisbaena_haughi	Amphisbaena_haugi	Cynisca_haugi
Cynisca_degrysi	Placogaster_degrysi	Cynisca_degrysi
Mesobaena_rhachicephala	Mesobaena_rhachicephala
Zygaspis_dolichomenta	Amphisbaena_dolichomenta	Shrevea_quadrifrons_dolichomenta	Zygaspis_quadrifrons_dolichomenta	Zygaspis_dolichomenta
Podarcis_raffoneae	Lacerta_raffonei	Lacerta_sicula_alvearioi	Lacerta_sicula_raffonei	Lacerta_wagleriana_antoninoi	Podarcis_raffoneae	Podarcis_raffonei_alvearioi	Podarcis_raffonei_antoninoi	Podarcis_siculus_cucchiarai	Podarcis_raffonei
Podarcis_levendis	Podarcis_levendis
Takydromus_madaensis	Takydromus_madaensis
Takydromus_hani	Takydromus_hani
Takydromus_haughtonianus	Tachydromus_haughtonianus	Takydromus_haughtonianus
Takydromus_sikkimensis	Tachydromus_sikkimensis	Takydromus_sikkimensis
Darevskia_pontica	Darevskia_praticola_hungarica	Darevskia_praticola_hyrcanica	Darevskia_praticola_loriensis	Darevskia_praticola_pontica	Lacerta_colchica	Lacerta_plicata	Lacerta_praticola	Lacerta_praticola_hungarica	Lacerta_praticola_pontica	Lacerta_vivipara_stenolepis	Darevskia_praticola
Darevskia_dryada	Lacerta_dryada	Darevskia_dryada
Darevskia_rostombekovi	Darevskia_rostombekovi	Lacerta_rostombekovi	Lacerta_saxicola_rostombekowi	Darevskia_rostombekowi
Anatololacerta_budaki	Anatololacerta_budaki	Anatololacerta_oertzeni_finikensis	Lacerta_oertzeni_budaki	Lacerta_oertzeni_finikensis	Anatololacerta_finikensis
Lacerta_mostoufii	Lacerta_boettgeri	Lacerta_chlorogaster	Lacerta_mostoufii	Darevskia_chlorogaster
Latastia_cherchii	Latastia_cherchii
Latastia_siebenrocki	Eremias_siebenrocki	Latastia_siebenrocki
Latastia_carinata	Lacerta_carinata	Latastia_carinata	Latastia_petersiana	Latastia_ventralis	Latastia_petersiana
Pseuderemias_erythrosticta	Eremias_erythrosticta	Pseuderemias_erythrosticta
Meroles_squamulosa	Ichnotropis_squamulosa	Meroles_squamulosus
Ichnotropis_chapini	Ichnotropis_chapini
Ichnotropis_tanganicana	Ichnotropis_tanganicana
Ichnotropis_grandiceps	Ichnotropis_grandiceps
Ichnotropis_microlepidota	Ichnotropis_microlepidota
Pedioplanis_huntleyi	Pedioplanis_huntleyi
Ophisops_minor	Cabrita_jerdoni_minor	Cabrita_jerdonii	Ophisops_minor	Ophisops_minor_nictans	Ophisops_nictans	Ophisops_nictans
Acanthodactylus_orientalis	Acanthodactylus_tristrami_iracensis	Acanthodactylus_orientalis
Acanthodactylus_lineomaculatus	Acanthodactylus_bellii	Acanthodactylus_erythrurus_atlanticus	Acanthodactylus_erythrurus_belli	Acanthodactylus_erythrurus_ksourensis	Acanthodactylus_erythrurus_lineomaculatus	Acanthodactylus_erythrurus_mauritanicus	Acanthodactylus_lineo-maculatus	Acanthodactylus_vulgaris	Acanthodactylus_vulgaris_atlantica	Lacerta_erythrura	Acanthodactylus_erythrurus
Acanthodactylus_scutellatus
Acanthodactylus_ahmaddisii	Acanthodactylus_ahmaddisii
Mesalina_ercolinii	Eremias_ercolinii	Mesalina_ercolinii
Eremias_kokshaaliensis	Eremias_kokshaaliensis
Eremias_montanus	Eremias_novo	Eremias_montana
Eremias_afghanistanica	Eremias_afghanistanica_bohme	Eremias_afghanistanica
Eremias_quadrifrons	Podarces_quadrifrons	Eremias_quadrifrons
Eremias_buechneri	Eremias_yarkandensis	Eremias_yarkandensis_saturata	Eremias_buechneri
Eremias_novo	Eremias_novo	Eremias_montana
Eremias_yarkandensis	Eremias_yarkandensis
Kaieteurosaurus_hindsi	Kaieteurosaurus_hindsi
Adercosaurus_vixadnexus	Adercosaurus_vixadenexus	Adercosaurus_vixadnexus
Leposoma_southi	Leposoma_bisecta	Leposoma_southi	Leposoma_southi_orientalis	Loxopholis_southi_orientalis	Loxopholis_southi
Leposoma_rugiceps	Leposoma_dispar	Leposoma_rugiceps	Loxopholis_rugiceps
Leposoma_ioanna	Leposoma_ioanna	Loxopholis_ioanna
Leposoma_guianense	Leposoma_guianense	Loxopholis_guianense
Leposoma_snethlageae	Leposoma_snethlageae	Loxopholis_snethlageae
Leposoma_caparensis	Leposoma_caparensis	Loxopholis_caparensis
Leposoma_percarinatum	Hylosaurus_muelleri	Hylosaurus_percarinatus	Lepidosoma_percarinatum	Leposoma_percarinatum	Leposoma_taeniata	Loxopholis_percarinatum
Leposoma_hexalepis	Leposoma_hexalepis	Loxopholis_hexalepis
Leposoma_parietale	Leposoma_parietale	Mionyx_parietale	Loxopholis_parietalis
Leposoma_ferreirai	Leposoma_ferreirai	Loxopholis_ferreirai
Leposoma_osvaldoi	Leposoma_osvaldoi	Loxopholis_osvaldoi
Marinussaurus_curupira	Marinussaurus_curupira
Colobosauroides_carvalhoi	Colobosauroides_carvalhoi
Leposoma_nanodactylus	Leposoma_nanodactylus
Leposoma_sinepollex	Leposoma_sinepollex
Leposoma_puk	Leposoma_puk
Arthrosaura_montigena	Arthrosaura_montigena
Arthrosaura_testigensis	Arthrosaura_testigensis
Arthrosaura_guianensis	Arthrosaura_guianensis	Yanomamia_guianensis
Arthrosaura_hoogmoedi	Arthrosaura_hoogmoedi	Yanomamia_hoogmoedi
Euspondylus_rahmi	Euspondylus_rahmi	Prionodactylus_rahmi	Proctoporus_rahmi
Euspondylus_oreades	Euspondylus_oreades	Proctoporus_oreades
Euspondylus_spinalis	Euspondylus_spinalis	Prionodactylus_spinalis	Proctoporus_spinalis
Euspondylus_monsfumus	Euspondylus_monsfumus
Euspondylus_josyi	Euspondylus_josyi	Wilsonosaura_josyi
Petracola_labioocularis	Proctoporus_labioocularis	Proctoporus_labioocularis_kohler	Petracola_labioocularis
Proctoporus_cephalolineatus	Proctoporus_cephalolineatus
Proctoporus_unsaacae	Proctoporus_unsaacae
Potamites_ocellatus	Neusticurus_ocellatus	Potamites_ocellatus
Potamites_erythrocularis	Potamites_erythrocularis
Potamites_apodemus	Echinosaura_apodemus	Neusticurus_apodemus	Potamites_apodemus	Centrosaura_apodema
Potamites_flavogularis	Potamites_flavogularis	Gelanesaurus_flavogularis
Potamites_cochranae	Neusticurus_cochranae	Neusticurus_ecpleopus_cochranae	Potamites_cochranae	Gelanesaurus_cochranae
Potamites_montanicola	Potamites_montanicola
Cercosaura_steyeri	Pantodactylus_steyeri	Cercosaura_steyeri
Cercosaura_nigroventris	Prionodactylus_nigroventris	Cercosaura_nigroventris
Cercosaura_vertebralis	Cercosaura_vertebralis	Euspondylus_ampuedae	Prionodactylus_marianus	Prionodactylus_palmeri	Prionodactylus_vertebralis	Pholidobolus_vertebralis
Cercosaura_dicra	Cercosaura_dicra	Prionodactylus_dicrus	Pholidobolus_dicrus
Cercosaura_phelpsorum	Euspondylus_goeleti	Euspondylus_phelpsi	Cercosaura_phelpsorum
Anadia_mcdiarmidi	Anadia_mcdiarmidi	Anadia_mcdiarmidi	Oreosaurus_mcdiarmidi
Anadia_pariaensis	Anadia_pariaensis
Anadia_escalerae	Anadia_escalerae	Anadia_escalerae
Anadia_altaserrania	Anadia_altaserrania
Anadia_hobarti	Anadia_hobarti
Anadia_blakei	Anadia_blakei
Anadia_bumanguesa	Anadia_bumanguesa
Pholidobolus_anomalus	Pholidobolus_anomalus	Cercosaura_anomala
Pholidobolus_hillisi	Pholidobolus_hillisi
Teuchocercus_keyi	Teuchocercus_keyi	Echinosaura_keyi
Riama_aurea	Riama_aurea	Riama_aurea_sanchez-pacheco	Andinosaura_aurea
Riama_stellae	Riama_stellae	Andinosaura_stellae
Riama_kiziriani	Riama_aurea_sanchez-pareco	Riama_kiziriani	Andinosaura_kiziriani
Riama_laudahnae	?_laudahnae	Proctoporus_laudahnae_kohler	Riama_laudahnae	Proctoporus_laudahnae
Riama_yumborum	Riama_yumborum	Riama_yumborum
Riama_inanis	Proctoporus_inanis	Riama_inanis
Riama_petrorum	Proctoporus_petrorum	Riama_petrorum	Andinosaura_petrorum
Riama_vieta	Riama_vieta
Riama_afrania	Riama_afrania	Andinosaura_afrania
Riama_balneator	Proctoporus_balneator	Riama_balneator
Riama_achlyens	Proctoporus_achlyens	Riama_achlyens	Oreosaurus_achlyens
Riama_shrevei	Proctoporus_shrevei	Riama_shrevei	Oreosaurus_shrevei
Riama_hyposticta	Riama_hyposticta
Riama_laevis	Oreosaurus_laevis	Riama_laevis	Andinosaura_laevis
Riama_rhodogaster	Riama_rhodogaster	Oreosaurus_rhodogaster
Riama_luctuosa	Ecpleopus_luctuosus	Proctoporus_luctuosus	Riama_luctuosa	Oreosaurus_luctuosus
Riama_crypta	Proctoporus_hypostictus	Riama_crypta	Riama_crypta_sanchez-pacheco	Andinosaura_crypta
Riama_oculata	Ecpleopus_oculatus	Oreosaurus_oculatus	Proctoporus_oculatus	Riama_oculata	Andinosaura_oculata
Placosoma_cipoense	Placosoma_cipoense
Echinosaura_sulcarostrum	Echinosaura_sulcarostrum	Rheosaurus_sulcarostrum
Bachia_psamophila	Bachia_psamophila
Bachia_scaea	Bachia_scaea
Bachia_micromela	Bachia_micromela
Bachia_oxyrhina	Bachia_oxyrhina	Bachia_oxyrhina
Bachia_didactyla	Bachia_didactyla
Vanzosaura_multiscutatus	Gymnophthalmus_multiscutatus	Vanzosaura_multiscutata
Psilophthalmus_paeminosus	Psilophthalmus_paeminosus	Psilops_paeminosus
Gymnophthalmus_pleei	Gymnophthalmus_pleei_nesydrion	Gymnophthalmus_pleii
Gymnophthalmus_cryptus	Gymnophthalmus_cryptus
Calyptommatus_confusionibus	Calyptommatus_confusionibus
Scriptosaura_catimbau	Scriptosaura_catimbau
Heterodactylus_septentrionalis	Heterodactylus_septentrionalis
Heterodactylus_lundii	Heterodactylus_lundii
Alexandresaurus_camacan	Alexandresaurus_camacan
Stenolepis_ridleyi	Stenolepis_ridleyi
Acratosaura_spinosa	Acratosaura_spinosa
Riolama_uzzelli	Riolama_uzzelli
Riolama_luridiventris	Riolama_luridiventris
Ptychoglossus_danieli	Ptychoglossus_danieli	Alopoglossus_danieli
Ptychoglossus_eurylepis	Ptychoglossus_eurylepis	Alopoglossus_eurylepis
Ptychoglossus_nicefori	Ptychoglossus_brevifrontalis	Ptychoglossus_nicefori	Alopoglossus_brevifrontalis
Ptychoglossus_festae	Euspondilus_festae	Euspondylus_strangulatus	Neusticurus_strangulatus_trachodus	Ptychoglossus_festae	Potamites_strangulatus
Ptychoglossus_vallensis	Ptychoglossus_vallensis	Alopoglossus_vallensis
Ptychoglossus_kugleri	Ptychoglossus_kugleri	Alopoglossus_kugleri
Ptychoglossus_gorgonae	Ptychoglossus_gorgonae	Alopoglossus_gorgonae
Ptychoglossus_brevifrontalis	Ptychoglossus_brevifrontalis	Ptychoglossus_nicefori	Alopoglossus_brevifrontalis
Ptychoglossus_grandisquamatus	Ptychoglossus_grandisquamatus	Alopoglossus_grandisquamatus
Ptychoglossus_bilineatus	Ptychoglossus_bilineatus	Alopoglossus_bilineatus
Ptychoglossus_romaleos	Ptychoglossus_romaleos	Alopoglossus_romaleos
Ptychoglossus_myersi	Ptychoglossus_myersi	Alopoglossus_myersi
Ameiva_taeniura	Ameiiva_navassae	Ameiua_taeniura_vafra	Ameiua_taeniura_varica	Ameiva_barbouri	Ameiva_navassae	Ameiva_rosamondae	Ameiva_taeniura	Ameiva_taeniura_aequorea	Ameiva_taeniura_algida	Ameiva_taeniura_azuae	Ameiva_taeniura_ignobilis	Ameiva_taeniura_meyerabichi	Ameiva_taeniura_pentamerinthus	Ameiva_taeniura_regnatrix	Ameiva_taeniura_tofacea	Ameiva_taeniura_vafra	Ameiva_taeniura_varica	Ameiva_taeniura_vulcanalis	Pholidoscelis_taeniurus_aequorea	Pholidoscelis_taeniurus_azuae	Pholidoscelis_taeniurus_barbouri	Pholidoscelis_taeniurus_ignobilis	Pholidoscelis_taeniurus_meyerabichi	Pholidoscelis_taeniurus_navassae	Pholidoscelis_taeniurus_pentamerinthus	Pholidoscelis_taeniurus_regnatrix	Pholidoscelis_taeniurus_rosamondae	Pholidoscelis_taeniurus_tofacea	Pholidoscelis_taeniurus_vafra	Pholidoscelis_taeniurus_varica	Pholidoscelis_taeniurus_vulcanalis	Pholidoscelis_taeniurus
Ameiva_maynardi	Ameiva_maynardi	Ameiva_maynardi_paruinaguae	Ameiva_maynardi_uniformis	Ameiva_maynardii	Amiva_leucomelas	Pholidoscelis_maynardi_parvinaguae	Pholidoscelis_maynardi_uniformis	Pholidoscelis_maynardi
Ameiva_lineolata	Ameiva_beatensis	Ameiva_lineolata	Ameiva_lineolata_meracula	Ameiva_lineolata_perplicata	Ameiva_lineolata_privigna	Ameiva_lineolata_semota	Pholidoscelis_lineolatus_beatensis	Pholidoscelis_lineolatus_meracula	Pholidoscelis_lineolatus_perplicata	Pholidoscelis_lineolatus_privigna	Pholidoscelis_lineolatus_semota	Pholidoscelis_lineolatus
Ameiva_corvina	Ameiva_corvina	Pholidoscelis_corvinus
Ameiva_cineracea	Ameiva_cineracea	Pholidoscelis_cineraceus
Ameiva_chrysolaema	Ameiva_abbotti	Ameiva_chrysolaema	Ameiva_chrysolaema_alacris	Ameiva_chrysolaema_boekeri	Ameiva_chrysolaema_defensor	Ameiva_chrysolaema_evulsa	Ameiva_chrysolaema_ficta	Ameiva_chrysolaema_jacta	Ameiva_chrysolaema_leberi	Ameiva_chrysolaema_parvoris	Ameiva_chrysolaema_procax	Ameiva_chrysolaema_quadrijugis	Ameiva_chrysolaema_richardthomasi	Ameiva_chrysolaema_secessa	Ameiva_chrysolaema_umbratilis	Ameiva_chrysolaema_woodi	Ameiva_regularis	Ameiva_vittipunctata	Cnemidophorus_affinis	Pholidoscelis_chrysolaemus_abbotti	Pholidoscelis_chrysolaemus_alacris	Pholidoscelis_chrysolaemus_boekeri	Pholidoscelis_chrysolaemus_defensor	Pholidoscelis_chrysolaemus_evulsa	Pholidoscelis_chrysolaemus_ficta	Pholidoscelis_chrysolaemus_jacta	Pholidoscelis_chrysolaemus_parvoris	Pholidoscelis_chrysolaemus_procax	Pholidoscelis_chrysolaemus_quadrijugis	Pholidoscelis_chrysolaemus_regularis	Pholidoscelis_chrysolaemus_richardthomasi	Pholidoscelis_chrysolaemus_secessa	Pholidoscelis_chrysolaemus_woodi	Pholidoscelis_chrysolaemus
Ameiva_dorsalis	Ameiva_dorsalis	Pholidoscelis_dorsalis
Ameiva_auberi	Ameiva_auberi	Ameiva_auberi_abducta	Ameiva_auberi_atrothorax	Ameiva_auberi_behringensis	Ameiva_auberi_bilateralis	Ameiva_auberi_cacuminis	Ameiva_auberi_citra	Ameiva_auberi_denticola	Ameiva_auberi_extorris	Ameiva_auberi_extraria	Ameiva_auberi_felis	Ameiva_auberi_festiva	Ameiva_auberi_focalis	Ameiva_auberi_galbiceps	Ameiva_auberi_garridoi	Ameiva_auberi_gemmea	Ameiva_auberi_granti	Ameiva_auberi_hardyi	Ameiva_auberi_kingi	Ameiva_auberi_llanensis	Ameiva_auberi_marcida	Ameiva_auberi_multilineata	Ameiva_auberi_nigriventris	Ameiva_auberi_obsoleta	Ameiva_auberi_orlandoi	Ameiva_auberi_parvinsulae	Ameiva_auberi_paulsoni	Ameiva_auberi_peradusta	Ameiva_auberi_procer	Ameiva_auberi_pullata	Ameiva_auberi_richmondi	Ameiva_auberi_sabulicolor	Ameiva_auberi_sanfelipensis	Ameiva_auberi_schwartzi	Ameiva_auberi_secta	Ameiva_auberi_sideroxylon	Ameiva_auberi_sublesta	Ameiva_auberi_ustulata	Ameiva_auberi_vulturnus	Ameiva_auberi_zugi	Ameiva_thoracica	Pholidoscelis_auberi_abducta	Pholidoscelis_auberi_atrothorax	Pholidoscelis_auberi_behringensis	Pholidoscelis_auberi_bilateralis	Pholidoscelis_auberi_cacuminis	Pholidoscelis_auberi_citra	Pholidoscelis_auberi_denticola	Pholidoscelis_auberi_extorris	Pholidoscelis_auberi_extraria	Pholidoscelis_auberi_felis	Pholidoscelis_auberi_focalis	Pholidoscelis_auberi_galbiceps	Pholidoscelis_auberi_garridoi	Pholidoscelis_auberi_gemmea	Pholidoscelis_auberi_granti	Pholidoscelis_auberi_hardyi	Pholidoscelis_auberi_kingi	Pholidoscelis_auberi_llanensis	Pholidoscelis_auberi_marcida	Pholidoscelis_auberi_multilineata	Pholidoscelis_auberi_nigriventris	Pholidoscelis_auberi_obsoleta	Pholidoscelis_auberi_orlandoi	Pholidoscelis_auberi_parvinsulae	Pholidoscelis_auberi_paulsoni	Pholidoscelis_auberi_peradusta	Pholidoscelis_auberi_procer	Pholidoscelis_auberi_pullata	Pholidoscelis_auberi_richmondi	Pholidoscelis_auberi_sabulicolor	Pholidoscelis_auberi_sanfelipensis	Pholidoscelis_auberi_schwartzi	Pholidoscelis_auberi_secta	Pholidoscelis_auberi_sideroxylon	Pholidoscelis_auberi_sublesta	Pholidoscelis_auberi_thoracica	Pholidoscelis_auberi_ustulata	Pholidoscelis_auberi_vulturnus	Pholidoscelis_auberi_zugi	Pholidoscelis_auberi
Ameiva_exsul	Ameiva_birdorum	Ameiva_exsul	Ameiva_plei_exsul	Ameiva_plei_exsul	Pholidoscelis_exsul_exsul	Pholidoscelis_exsul
Ameiva_wetmorei	Ameiva_eleanorae	Ameiva_wetmorei	Ameiva_wetmorei_eleanorae	Pholidoscelis_wetmorei
Ameiva_polops	Ameiva_polops	Ameiva_orstedii	Pholidoscelis_polops
Ameiva_fuscata	Ameiva_fuscata	Pholidoscelis_fuscatus
Ameiva_pluvianotata	Ameiva_pluvianotata	Pholidoscelis_pluvianotatus
Ameiva_major	Ameiva_major	Pholidoscelis_major
Ameiva_griswoldi	Ameiva_griswoldi	Pholidoscelis_griswoldi
Ameiva_plei	Ameica_pleii	Ameiva_analifera	Ameiva_garmani	Ameiva_plei	Ameiva_plei_analifera	Ameiva_scutata	Pholidoscelis_plei_analiferus	Pholidoscelis_plei
Ameiva_corax	Ameiva_corax	Pholidoscelis_corax
Ameiva_atrata	Ameiva_atrata	Pholidoscelis_atratus
Aspidoscelis_xanthonota	Aspidoscelis_burti_xanthonota	Cnemidophorus_burti_xanthonotus	Cnemidophorus_sacki_xanthonotus	Cnemidophorus_xanthonotus	Aspidoscelis_xanthonotus
Aspidoscelis_picta	Cnemidophorus_hyperythrus_pictus	Cnemidophorus_pictus	Verticaria_picta	Aspidoscelis_pictus
Aspidoscelis_inornata	Aspidoscelis_arizonae	Aspidoscelis_gypsi	Aspidoscelis_inornatus_arizonae	Aspidoscelis_inornatus_chihuahuae	Aspidoscelis_inornatus_cienegae	Aspidoscelis_inornatus_gypsi	Aspidoscelis_inornatus_heptagrammus	Aspidoscelis_inornatus_juniperus	Aspidoscelis_inornatus_llanuras	Aspidoscelis_inornatus_paululus	Cnemidophorus_arizonae	Cnemidophorus_gularis_velox	Cnemidophorus_inornatus	Cnemidophorus_inornatus	Cnemidophorus_inornatus_chihuahuae	Cnemidophorus_inornatus_cienegae	Cnemidophorus_inornatus_gypsi	Cnemidophorus_inornatus_heptagrammus	Cnemidophorus_inornatus_juniperus	Cnemidophorus_inornatus_llanuras	Cnemidophorus_inornatus_paululus	Cnemidophorus_inornatus_paululus	Cnemidophorus_octolineatus	Cnemidophorus_perplexus	Aspidoscelis_inornatus
Aspidoscelis_sexlineata	Aspidoscelis_sexlineatus_stephensae	Aspidoscelis_sexlineatus_viridis	Cnemidophorus_sexlineatus	Cnemidophorus_sexlineatus_oligoporus	Cnemidophorus_sexlineatus_pauciporus	Cnemidophorus_sexlineatus_stephensi	Cnemidophorus_sexlineatus_viridis	Lacerta_sexlineata	Aspidoscelis_sexlineatus
Aspidoscelis_mexicana	Cnemidophorus_mexicanus	Aspidoscelis_mexicanus
Aspidoscelis_stictogramma	Aspidoscelis_burti_stictogramma	Cnemidophorus_burti_stictogrammus	Cnemidophorus_sackii_stictogrammus	Aspidoscelis_stictogrammus
Aspidoscelis_cozumelae	Aspidoscelis_cozumelae	Cnemidophorus_cozumela	Cnemidophorus_deppei_cozumela	Aspidoscelis_cozumela
Aspidoscelis_costata	Aspidoscelis_alpinus	Aspidoscelis_costatus_barrancorum	Aspidoscelis_costatus_griseocephalus	Aspidoscelis_costatus_huico	Aspidoscelis_costatus_mazatlanensis	Aspidoscelis_costatus_nigrigularis	Aspidoscelis_costatus_occidentalis	Aspidoscelis_costatus_zweifeli	Cnemidophorus_alpinus	Cnemidophorus_communis_occidentalis	Cnemidophorus_costatus	Cnemidophorus_sacki_barrancorum	Cnemidophorus_sacki_griseocephalus	Cnemidophorus_sacki_huico	Cnemidophorus_sacki_mazatlanensis	Cnemidophorus_sacki_nigrigularis	Cnemidophorus_sacki_zweifeli	Aspidoscelis_costatus
Aspidoscelis_guttata	Aspidoscelis_guttatus_flavilineatus	Aspidoscelis_guttatus_immutabilis	Cnemidophorus_guttatus	Cnemidophorus_guttatus_flavilineatus	Cnemidophorus_guttatus_immutabilis	Cnemidophorus_guttatus_striatus	Cnemidophorus_immutabilis	Cnemidophorus_microlepidopus	Cnemidophorus_unicolor	Aspidoscelis_guttatus
Aspidoscelis_hyperythra	Aspidoscelis_hyperythrus_beldingi	Aspidoscelis_hyperythrus_schmidti	Cnemidophorus_hyperythrus	Cnemidophorus_hyperythrus_hyperythrus	Verticaria_beldingi	Verticaria_espiritensis	Verticaria_franciscensis	Verticaria_hyperythra_schmidti	Aspidoscelis_hyperythrus
Aspidoscelis_maxima	Cnemidophorus_maximus	Aspidoscelis_maximus
Aspidoscelis_neomexicana	Cnemidophorus_neomexicanus	Cnemidophorus_perplexus	Aspidoscelis_neomexicanus
Aspidoscelis_tesselata	Ameiva_tesselata	Aspidoscelis_dixoni	Cnemidophorus_dixoni	Cnemidophorus_grahamii	Cnemidophorus_tesselatus	Aspidoscelis_tesselatus
Aspidoscelis_lineattissima	Aspidoscelis_lineattissimus_duodecemlineatus	Aspidoscelis_lineattissimus_exoristus	Aspidoscelis_lineattissimus_lividus	Cnemidophorus_lineattissimus	Cnemidophorus_lineattissimus_duodecemlineatus	Cnemidophorus_lineattissimus_exoristus	Cnemidophorus_lineattissimus_lividus	Aspidoscelis_lineattissimus
Aspidoscelis_neotesselata	Cnemidophorus_neotessalatus	Cnemidophorus_neotesselatus	Aspidoscelis_neotesselatus
Aspidoscelis_parvisocia	Cnemidophorus_communis_australis	Cnemidophorus_parvisocius	Cnemidophorus_sexlineatus_gularis	Aspidoscelis_parvisocius
Aspidoscelis_flagellicauda	Aspidoscelis_flagellicauda	Cnemidophorus_flagellicaudus	Cnemidophorus_sonorae	Aspidoscelis_sonorae
Aspidoscelis_deppei	Aspidoscelis_deppii_infernalis	Aspidoscelis_deppii_schizophorus	Cnemidophorus_alfaronis	Cnemidophorus_decemlineatus	Cnemidophorus_deppei_oligoporus	Cnemidophorus_deppei_schizophorus	Cnemidophorus_deppii	Cnemidophorus_deppii_infernalis	Cnemidophorus_lativittis	Aspidoscelis_deppii
Aspidoscelis_marmorata	Aspidoscelis_marmoratus_reticuloriens	Aspidoscelis_tigris_marmorata	Cnemidophorus_marmoratus	Cnemidophorus_marmoratus_reticuloriens	Cnemidophorus_tigris_marmoratus	Aspidoscelis_marmoratus
Kentropyx_lagartija	Kentropyx_lagartija
Cnemidophorus_flavissimus	Cnemidophorus_flavissimus
Cnemidophorus_martyris
Ameivula_venetacauda	Ameivula_venetacauda	Cnemidophorus_venetacaudus	Glaucomastix_venetacauda
Ameivula_littoralis	Ameivula_littoralis	Cnemidophorus_littoralis	Glaucomastix_littoralis
Ameivula_abaetensis	Ameivula_abaetensis	Cnemidophorus_abaetensis	Glaucomastix_abaetensis
Ameivula_cyanura	Ameivula_cyanura	Cnemidophorus_cyanurus	Glaucomastix_cyanura
Ameivula_confusioniba	Cnemidophorus_confusionibus	Ameivula_confusioniba
Ameiva_concolor	Ameiva_bifrontata_concolor	Ameiva_concolor
Ameiva_provitaae	Ameiva_provitaae
Ameiva_jacuba	Ameiva_jacuba
Lepidophyma_cuicateca	Lepidophyma_cuicateca
Tetradactylus_udzungwensis	Tetradactylus_udzungwensis
Zonosaurus_anelanelany	Zonosaurus_anelanelany
Platysaurus_pungweensis	Platysaurus_guttatus_blakei	Platysaurus_guttatus_pungweensis	Platysaurus_intermedius_blakei	Platysaurus_pungweensis
Smaug_regius	Cordylus_regius	Cordylus_warreni_regius	Smaug_regius
Cordylus_nyikae	Cordylus_nyikae
Cordylus_aridus	Cordylus_aridus
Cordylus_rivae	Cordylus_cordylus_rivae	Zonurus_rivae	Cordylus_rivae
Cordylus_meculae	Cordylus_meculae
Cordylus_angolensis	Cordylus_cordylus_angolensis	Zonurus_angolensis	Cordylus_angolensis
Cyclodomorphus_maxima	Omolepida_maxima	Tiliqua_maxima	Cyclodomorphus_maximus
Hemisphaeriodon_gerrardii	Hemisphaeriodon_gerrardii	Hinulia_gerrardii	Hinulia_picta	Tiliqua_longicauda	Cyclodomorphus_gerrardii
Eutropis_novemcarinata	Euprepes_novemcarinatus	Eutropis_novemcarinata	Mabuya_novemcarinata	Toenayar_novemcarinata
Trachylepis_aurata	Euprepis_auratus	Euprepis_fellowsii	Lacerta_aurata	Mabuya_aurata	Mabuya_transcaucasica	Trachylepis_aurata	Heremites_auratus
Trachylepis_vittata	Euprepes_olivieri	Euprepes_vittatus	Euprepis_vittatus	Eutropis_vittata	Mabuia_vittata	Mabuya_vittata	Scincus_vittatus	Trachylepis_vittata	Heremites_vittatus
Mabuya_cochonae	Mabuya_cochonae
Mabuya_grandisterrae	Mabuya_grandisterrae
Mabuya_guadeloupae	Mabuya_guadeloupae
Alinea_lanceolata	Mabuia_lanceolata	Alinea_lanceolata
Alinea_pergravis	Alinea_pergravis	Mabuya_pergravis	Marisora_pergravis
Alinea_berengerae	Alinea_berengerae	Mabuya_berengerae	Marisora_berengerae
Spondylurus_monitae	Spondylurus_monitae
Spondylurus_turksae	Spondylurus_turksae
Spondylurus_spilonotus	Euprepes_spilonotus	Spondylurus_spilonotus
Spondylurus_magnacruzae	Spondylurus_magnacruzae
Vietnascincus_rugosus	Vietnascincus_rugosus
Copeoglossum_redondae	Copeoglossum_redondae
Eumecia_johnstoni	Lygosoma_johnstoni	Eumecia_johnstoni
Chioninia_geisthardti	Chioninia_geisthardti	Euprepes_fogoensis	Mabuya_fogoensis	Mabuya_fogoensis_antaoensis	Mabuya_geisthardti	Chioninia_fogoensis
Trachylepis_cristinae	Trachylepis_cristinae
Trachylepis_loluiensis	Trachylepis_loluiensis
Trachylepis_septemtaeniata	Euprepis_septemtaeniatus	Mabuya_aurata_septemtaeniata	Trachylepis_septemtaeniata	Heremites_septemtaeniatus
Trachylepis_infralineata	Mabuya_comorensis_infralineata	Trachylepis_infralineata
Trachylepis_nancycoutuae	Mabuya_nancycoutuae	Trachylepis_nancycoutuae
Trachylepis_ferrarai	Euprepis_ferrarai	Mabuya_ferrarai	Trachylepis_ferrarai
Trachylepis_betsileana	Euprepis_betsileana	Mabuia_betsileana	Mabuya_betsileana	Trachylepis_betsileana
Trachylepis_ivensii	Euprepes_ivensii	Euprepis_ivensii	Lygosoma_ivensii	Mabuia_ivensii	Mabuya_ivensi_septemlineata	Mabuya_ivensii	Trachylepis_ivensii	Lubuya_ivensii
Trachylepis_angolensis	Mabuya_striata_angolensis	Trachylepis_angolensis	Trachylepis_monardi
Dasia_subcaeruleum	Dasia_subcoerulea	Lygosoma_subcaeruleum	Dasia_subcaerulea
Capitellum_mariagalantae	Capitellum_mariagalantae
Capitellum_parvicruzae	Capitellum_parvicruzae
Capitellum_metallicum	Mabuya_metallica	Capitellum_metallicum
Eutropis_darevskii	Mabuya_darevskii	Eutropis_darevskii
Lamprolepis_vyneri	Lamprolepis_vyneri
Lamprolepis_leucosticta	Dasia_leucosticta	Lygosoma_leucostictum	Lamprolepis_leucosticta
Eutropis_chapaensis	?_chapaensis	Mabuya_chapaensis	Tiliqua_chapaense	Eutropis_chapaensis
Eutropis_innotata	Euprepes_innotatus	Mabuia_innotata	Mabuya_innotata	Eutropis_innotata
Eutropis_floweri	Mabuya_floweri	Eutropis_floweri
Eutropis_beddomii	Euprepes_beddomei	Euprepes_septemlineatus	Mabuia_beddomii	Mabuya_beddomii	Eutropis_beddomei
Eutropis_quadratilobus	Mabuya_quadratilobus	Mabuya_quadratolobus	Eutropis_quadratilobus
Eutropis_grandis	Eutropis_grandis	Mabuya_macrophthalma	Eutropis_macrophthalma
Eutropis_gansi	Eutropis_gansi
Lankascincus_greeri	Lankascincus_greeri	Sphenomorphus_deignani	Lankascincus_deignani
Lankascincus_deraniyagalae	Lankascincus_deraniyagalae	Lygosoma_fallax	Sphenomorphus_rufogulus	Lankascincus_fallax
Lankascincus_munindradasai	Eumeces_taprobanensis	Lankascincus_munindradasai	Lygosoma_punctatolineatum	Lygosoma_striatopunctatum	Lygosoma_taprobanense	Sphenomorphus_striatopunctatum	Lankascincus_taprobanensis
Lygosoma_anguinum	Lygosoma_anguininum	Lygosoma_anguinum	Riopa_anguina	Riopa_anguina
Lygosoma_pruthi	Lygosoma_pruthi	Riopa_pruthi	Subdoluseps_pruthi
Lygosoma_herberti	Lygosoma_herberti	Riopa_herberti	Sphenosoma_hughi	Subdoluseps_herberti
Lygosoma_mafianum	Lygosoma_mafianum	Mochlus_mafianus
Lygosoma_bowringii	Eumeces_indicus	Hinulia_indica	Lygosoma_bowringi	Lygosoma_cacharense	Lygosoma_formosensis	Lygosoma_indicum	Lygosoma_indicum	Lygosoma_indicum_indicum	Lygosoma_indicum_multilineatum	Lygosoma_indicum_taeniatum	Lygosoma_zebratum	Sphenomorphus_formosensis	Sphenomorphus_indicus	Sphenomorphus_indicus_formosensis	Sphenomorphus_indicus
Lygosoma_singha	Riopa_singhum	Lygosoma_singha
Lygosoma_lanceolatum	Lygosoma_lanceolatum	Mochlus_lanceolatus
Mochlus_mabuiiforme	Lygosoma_mabuiiforme	Riopa_mabuiiformis	Riopa_mabuiiformis	Mochlus_mabuiiformis
Mochlus_grandisonianum	Lygosoma_grandisonianum	Mochlus_grandisonianus
Mochlus_productum	Lygosoma_productum	Riopa_producta	Mochlus_productus
Mochlus_paedocarinatum	Lygosoma_laeviceps_paedocarinatum	Lygosoma_paedocarinatum	Mochlus_laeviceps_paedocarinatus	Mochlus_paedocarinatus
Mochlus_afer	?_sundevalli	Eumeces_afer	Eumeces_perdicicolor	Eumeces_reticulatus	Eumices_sunderallii	Lygosoma_sphenopiforme	Lygosoma_sundevalli	Lygosoma_sundevallii_sundevallii	Mochlus_afer	Riopa_sundevalli	Mochlus_sundevallii
Mochlus_sundevalli	?_sundevalli	Eumeces_afer	Eumeces_perdicicolor	Eumeces_reticulatus	Eumices_sunderallii	Lygosoma_sphenopiforme	Lygosoma_sundevalli	Lygosoma_sundevallii_sundevallii	Mochlus_afer	Riopa_sundevalli	Mochlus_sundevallii
Mochlus_simonettai	Lygosoma_simonettai	Mochlus_simonettai
Mochlus_mocquardi	Lygosoma_mocquardi	Riopa_mocquardi	Mochlus_mocquardi
Mochlus_somalicum	Lygosoma_somalicum	Lygosoma_sundevalli_somalicum	Riopa_modesta_somalica	Mochlus_somalicus
Lygosoma_lineolatum	Lygosoma_calamus	Lygosoma_feae	Lygosoma_lineolatum	Riopa_cyanella	Riopa_lineolata	Riopa_lineolata
Lygosoma_corpulentum	Lygosoma_carinatum	Riopa_corpulenta	Lygosoma_corpulentum
Lygosoma_ashwamedhi	Lygosoma_ashwamedhi	Riopa_ashwamedhi	Eutropis_ashwamedhi
Lygosoma_frontoparietale	Lygosoma_frontoparietale	Riopa_frontoparietalis	Subdoluseps_frontoparietalis
Lygosoma_popae	Lygosoma_popae	Riopa_popae	Riopa_popae
Lygosoma_laeviceps	Euprepes_laeviceps	Lygosoma_laeviceps	Riopa_laeviceps	Mochlus_laeviceps
Lygosoma_boehmei	Lygosoma_boehmei
Lygosoma_pembanum	Lygosoma_pembanum	Riopa_pembana	Mochlus_pembanus
Lygosoma_vosmaeri	Campsodactylus_lamarrei	Hagria_vosmaeri	Lygosoma_vosmaeri	Riopa_vosmaerii
Lygosoma_lineata	Chiamela_lineata	Lygosoma_lineata	Riopa_lineata
Lygosoma_carinatum	Lygosoma_carinatum	Riopa_corpulenta	Lygosoma_corpulentum
Lygosoma_guentheri	Eumeces_guentheri	Eumeces_guntheri	Eumeces_punctatus	Lygosoma_guentheri	Riopa_guentheri
Lygosoma_goaensis	Lygosoma_goaensis	Riopa_goaensis	Riopa_goaensis
Lygosoma_albopunctata	Eumeces_albopunctatus	Lygosoma_albopunctata	Riopa_albopunctata	Riopa_albopunctata
Lygosoma_chaperi	?_guineense	Euprepes_chaperi	Euprepes_guineensis	Lygosoma_chaperi	Lygosoma_guineense	Lygosoma_guineensis	Mochlus_sundevalli_guineensis	Riopa_guineense	Mochlus_guineensis
Lepidothyris_striatus	Euprepes_leoninus	Euprepis_striata	Lepidothyris_striatus	Mochlus_striatus
Lepidothyris_hinkeli	Lepidothyris_hinkeli	Mochlus_hinkeli
Lepidothyris_fernandi	Lepidothyris_fernandi	Plestiodon_harlani	Tiliqua_fernandi	Tiliqua_nigripes	Mochlus_fernandi
Lygosoma_veunsaiensis	Lygosoma_veunsaiensis
Lygosoma_opisthorhodum	Riopa_opisthorhodum	Lygosoma_opisthorhodum
Haackgreerius_miopus	Lygosoma_miopus	Haackgreerius_miopus
Ablepharus_lindbergi	Ablepharus_bivittatus_lindbergi	Ablepharus_lindbergi
Asymblepharus_mahabharatus	Asymblepharus_mahabharatus	Asymblepharus_mahabharatus
Asymblepharus_nepalensis	Asymblepharus_nepalensis	Asymblepharus_nepalensis
Asymblepharus_tragbulense	Ablepharus_tragbulensis	Lygosoma_himalayanum_tragbulensis	Asymblepharus_tragbulensis
Asymblepharus_eremchenkoi	Ablepharus_eremchenkoi	Asymblepharus_eremchenkoi
Panaspis_tancredi	Ablepharus_tancredi	Panaspis_tancredii
Panaspis_burgeoni	Lygosoma_burgeoni	Panaspis_burgeoni
Panaspis_helleri	Lygosoma_helleri	Siaphos_helleri	Siaphos_meleagris_helleri	Panaspis_helleri
Panaspis_nimbaensis	Lygosoma_nimbense	Panaspis_nimbaensis	Panaspis_nimbensis	Panaspis_nimbensis	Riopa_tristaoi	Panaspis_tristaoi
Afroablepharus_wahlbergi	Ablepharus_carsonii	Ablepharus_massaiensis	Afroablepharus_wahlbergi	Afroablepharus_walbergii	Cryptoblepharus_wahlbergi	Cryptoblepharus_walbergii	Panaspis_wahlbergii
Afroablepharus_duruarum	Ablepharus_duruarum	Afroablepharus_duruarum	Panaspis_duruarum
Afroablepharus_seydeli	Ablepharus_moeruensis	Ablepharus_seydeli	Ablepharus_smithii	Afroablepharus_seydeli	Panaspis_seydeli
Afroablepharus_wilsoni	Ablepharus_wilsoni	Ablepharus_wilsoni	Afroablepharus_wilsoni	Panaspis_wilsoni
Afroablepharus_africanus	Afroablepharus_africana	Leiolopisma_africana	Lygosoma_africanum	Mocoa_africana	Riopa_africanum	Panaspis_africana
Afroablepharus_maculicollis	Afroablepharus_maculicollis	Cryptoblepharus_wahlbergii	Panaspis_maculicollis	Panaspis_maculicollis
Afroablepharus_annobonensis	Afroablepharus_annobonensis	Panaspis_africana_annobonensis	Panaspis_annobonensis
Bassiana_duperreyi	Acritoscincus_buddeni	Bassiana_duperreyi	Tiliqua_duperreyi	Acritoscincus_duperreyi
Bassiana_platynota	Acritoscincus_donnellani	Bassiana_platynota	Lygosoma_platynotum	Acritoscincus_platynotus
Bassiana_trilineata	Bassiana_trilineatus	Leiolopisma_trilineatum	Lygosoma_trilineatum	Pseudemoia_trilineatum	Tiliqua_trilineata	Acritoscincus_trilineatus
Proablepharus_kinghorni	Ablepharus_kinghorni	Proablepharus_barklyensis	Proablepharus_kinghorni	Austroablepharus_kinghorni
Proablepharus_naranjicaudus	Proablepharus_naranjicaudus	Austroablepharus_naranjicauda
Proablepharus_barrylyoni	Proablepharus_barrylyoni	Austroablepharus_barrylyoni
Carlia_rimula	Carlia_rimula	Lygisaurus_rimula
Carlia_sukur	Carlia_sukur
Lygisaurus_abscondita	Carlia_abscondita	Lygisaurus_absconditus
Niveoscincus_greeni	Leiolopisma_greeni	Niveoscincus_greeni	Carinascincus_greeni
Niveoscincus_orocryptus	Leiolopisma_orocryptum	Niveoscincus_orocryptus	Carinascincus_orocryptus
Niveoscincus_pretiosus	Mocoa_microlepidota	Mocoa_pretiosa	Niveoscincus_pretiosus	Carinascincus_pretiosus
Niveoscincus_metallicus	Leiolopisma_metallicus	Mocoa_metallica	Mocoa_ocellata	Mocoa_pseudocarinata	Niveoscincus_metallicus	Carinascincus_metallicus
Niveoscincus_ocellatus	Lygosoma_hieroglyphicum	Mocoa_ocellata	Niveoscincus_ocellatus	Carinascincus_ocellatus
Niveoscincus_palfreymani	Niveoscincus_palfreymani	Pseudemoia_palfreymani	Carinascincus_palfreymani
Niveoscincus_microlepidotus	Mocoa_microlepidota	Niveoscincus_microlepidotus	Carinascincus_microlepidotus
Niveoscincus_coventryi	Leiolopisma_coventryi	Niveoscincus_coventryi	Carinascincus_coventryi
Lobulia_stellaris	Lobulia_stellaris	Nubeoscincus_stellaris
Lobulia_alpina	Lobulia_alpina	Alpinoscincus_alpinus
Lobulia_glacialis	Lobulia_glacialis	Nubeoscincus_glacialis
Lobulia_subalpina	Lobulia_subalpina	Alpinoscincus_subalpinus
Cryptoblepharus_ahli	Cryptoblepharus_ahli
Emoia_ahli	Emoia_ahli	Lygosoma_ahli	Lygosoma_battersbyi	Emoia_battersbyi
Emoia_digul	Emoia_digul
Emoia_nativittatis	Lygosoma_nativitatis	Emoia_nativitatis
Emoia_lawesi	Mabouia_lawesii	Emoia_lawesii
Emoia_laobaoense	Emoia_laobaoense
Menetia_amaura	Menetia_amaura
Lioscincus_novaecaledoniae	?_novaecaledoniae	Lioscincus_novaecaledoniae	Lygosoma_novae-caledoniae	Caesoris_novaecaledoniae
Nannoscincus_rankini	Nannoscincus_rankini
Marmorosphax_kaala	Marmorosphax_kaala
Marmorosphax_boulinda	Marmorosphax_boulinda
Marmorosphax_taom	Marmorosphax_taom
Lioscincus_greeri	Leiolopisma_greeri	Lioscincus_greeri	Epibator_greeri
Simiscincus_aurantiacus	Simiscincus_aurantiacus
Caledoniscincus_constellatus	Caledoniscincus_constellatus
Caledoniscincus_pelletieri	Caledoniscincus_pelletieri
Caledoniscincus_cryptos	Caledoniscincus_cryptos
Cophoscincopus_senegalensis	Cophoscincopus_senegalensis	Cophoscincopus_senegalensis
Lioscincus_nigrofasciolatum	Lioscincus_nigrofasciolatum	Lygosoma_arborum	Lygosoma_deplanchei	Lygosoma_nigrofasciolatum	Epibator_nigrofasciolatus
Lioscincus_maruia	Lioscincus_maruia	Phasmasaurus_maruia
Lioscincus_tillieri	Leiolopisma_tillieri	Lioscincus_tillieri	Phasmasaurus_tillieri
Tachygyia_microlepis	Eumeces_microlepis	Tachygia_microlepis	Tachygyia_microlepis
Geoscincus_haraldmeieri	Eugongylus_haraldmeieri	Geoscincus_haraldmeieri
Oligosoma_lichenigera	Cyclodina_lichenigera	Mocoa_lichenigera	Oligosoma_lichenigerum
Oligosoma_hardyi	Cyclodina_aenea	Cyclodina_hardyi	Oligosoma_hardyi
Oligosoma_taumakae	Oligosoma_taumakae
Oligosoma_roimata	Oligosoma_roimata
Leiolopisma_fasciolare	Hombronia_fasciolaris	Leiolopisma_fasciolare
Leiolopisma_ceciliae	Leiolopisma_borbonica	Leiolopisma_ceciliae
Lacertaspis_reichenowi	Lygosoma_reichenowii	Panaspis_reichenowi	Lacertaspis_reichenowii
Lacertaspis_chriswildi	Panaspis_chriswildi	Lacertaspis_chriswildi
Leptosiaphos_dungeri	Leptosiaphos_dungeri	Leptosiaphos_dungeri
Leptosiaphos_hylophilus	Leptosiaphos_hylophilus
Leptosiaphos_koutoui	Leptosiaphos_koutoui
Leptosiaphos_fuhni	Panaspis_fuhni	Leptosiaphos_fuhni
Eugongylus_sulaensis	Lygosoma_sulaense	Eugongylus_sulaensis
Larutia_nubisilvicola	Larutia_nubisilvicola
Larutia_puehensis	Larutia_puehensis
Larutia_trifasciata	Lygosoma_trifasciatum	Larutia_trifasciata
Larutia_sumatrensis	Chelomeles_sumatrensis	Lygosoma_sumatrensis	Larutia_sumatrensis
Sphenomorphus_shelfordi	Lygosoma_shelfordi	Sphenomorphus_shelfordi
Sphenomorphus_malayanum	Lygosoma_malayanum	Sphenomorphus_malayanus
Sphenomorphus_maculicollus	Sphenomorphus_maculicollus
Sphenomorphus_capitolythos	Lygosoma_keiensis	Sphenomorphus_capitolythos	Sphenomorphus_capitolythos
Sphenomorphus_sananus	Lygosoma_sananus	Sphenomorphus_sanaus	Sphenomorphus_sanana
Sphenomorphus_sheai	Sphenomorphus_sheai
Sphenomorphus_textum	Lygosoma_textum	Sphenomorphus_textus	Tytthoscincus_textus
Sphenomorphus_vanheurni	Lygosoma_vanheurni	Sphenomorphus_vanheurni_balicus	Sphenomorphus_vanheurni
Sphenomorphus_temmincki	?_temmincki	Gongylus_temminckii	Sphenomorphus_temmincki	Tytthoscincus_temmincki
Sphenomorphus_temengorensis	Sphenomorphus_temengorensis	Tytthoscincus_temengorensis
Sphenomorphus_bukitensis	Sphenomorphus_bukitensis	Tytthoscincus_bukitensis
Sphenomorphus_tridigitus	Siaphos_tridigitus	Sphenomorphus_tridigitus
Sphenomorphus_sibuensis	Sphenomorphus_sibuensis	Tytthoscincus_sibuensis
Sphenomorphus_misolense	Lygosoma_misolense	Lygosoma_sima	Lygosoma_totocarinatum	Sphenomorphus_melanopleurus	Sphenomorphus_misolense	Sphenomorphus_simus
Sphenomorphus_courcyanum	Lygosoma_courcyanum	Sphenomorphus_courcyanus
Sphenomorphus_celebense	Lygosoma_celebense	Sphenomorphus_celebense	Sphenomorphus_celebensis
Sphenomorphus_grandisonae	Sphenomorphus_grandisonae
Sphenomorphus_orientale	Lygosoma_orientale	Sphenomorphus_orientale	Sphenomorphus_orientalis
Sphenomorphus_bacboensis	Livorimica_bacboensis	Sphenomorphus_bacboensis
Sphenomorphus_striatopunctatum	Eumeces_taprobanensis	Lankascincus_munindradasai	Lygosoma_punctatolineatum	Lygosoma_striatopunctatum	Lygosoma_taprobanense	Sphenomorphus_striatopunctatum	Lankascincus_taprobanensis
Sphenomorphus_cophias	Sphenomorphus_cophias	Tytthoscincus_cophias	Sphenomorphus_cophias
Sphenomorphus_modigliani	Lygosoma_modigliani	Sphenomorphus_modiglianii
Sphenomorphus_butleri
Sphenomorphus_perhentianensis	Sphenomorphus_perhentianensis	Tytthoscincus_perhentianensis
Sphenomorphus_zimmeri	Lygosoma_zimmeri	Sphenomorphus_variegatus	Sphenomorphus_zimmeri
Sphenomorphus_microtympanus	Sphenomorphus_microtympanum
Sphenomorphus_buettikoferi	Lygosoma_buettikoferi	Lygosoma_buttikoferi	Sphenomorphus_buettikoferi
Sphenomorphus_alfredi	Lygosoma_alfredi	Sphenomorphus_alfredi
Sphenomorphus_mimikanum	Lygosoma_mimikanum	Sphenomorphus_mimikanus
Sphenomorphus_ishaki	Sphenomorphus_ishaki	Tytthoscincus_ishaki
Sphenomorphus_rarus	Sphenomorphus_rarus
Sphenomorphus_crassus	Sphenomorphus_crassus
Sphenomorphus_megalops	Lygosoma_megalops	Sphenomorphus_megalops	Lankascincus_megalops
Sphenomorphus_schlegeli	Homolepida_schlegeli	Omolepida_schlegeli	Sphenomorphus_oxycephalus	Sphenomorphus_schlegeli	Sphenomorphus_schlegeli
Sphenomorphus_langkawiensis	Lygosoma_butleri	Sphenomorphus_langkawiensis	Tytthoscincus_langkawiensis	Tytthoscincus_butleri
Sphenomorphus_tanahtinggi	Sphenomorphus_tanahtinggi
Parvoscincus_igorotorum	Sphenomorphus_igorotorum	Parvoscincus_igorotorum
Parvoscincus_boyingi	Sphenomorphus_boyingi	Parvoscincus_boyingi
Parvoscincus_luzonense	?_luzonensis	Lygosoma_luzonense	Sphenomorphus_bakeri	Sphenomorphus_luzonense	Sphenomorphus_luzonensis	Parvoscincus_luzonensis
Leptoseps_osellai	Larutia_osellai	Leptoseps_osellai
Leptoseps_poilani	Siaphos_poilani	Leptoseps_poilani
Otosaurus_cumingi	Euprepes_otus	Otosaurus_cumingii
Concinnia_brachyosoma	Concinnia_brachyosoma	Eulamprus_brachysoma	Lygosoma_brachysoma	Lygosoma_brachysoma_lonnberg	Concinnia_brachysoma
Concinnia_tigrinus	Eulamprus_tigrinus	Hinulia_tigrina	Sphenomorphus_tigrinus	Concinnia_tigrina
Concinnia_amplus	Eulamprus_amplus	Sphenomorphus_amplus	Concinnia_ampla
Concinnia_queenslandiae	Concinnia_queenslandiae	Tropidophorus_queenslandiae	Gnypetoscincus_queenslandiae
Anomalopus_verreauxi	Anomalopus_godeffroyi	Anomalopus_verreauxii	Chelomeles_pseudopus	Siaphus_simplex	Anomalopus_verreauxii
Ctenotus_aphrodite	Ctenotus_aphrodite
Lerista_zietzi	Lerista_zietzi	Lerista_chalybura
Lerista_rhodonoides	Ablepharus_rhodonoides	Ablepharus_timidus	Lerista_rhodonoides	Lerista_timida
Lerista_maculosa	Lerista_maculosa
Lerista_talpina	Lerista_talpina
Anomalopus_pluto	Anomalopus_pluto	Sepsiscus_pluto
Glaphyromorphus_crassicaudus	Eremiascincus_crassicaudis	Gongylus_crassicaudum	Homolepida_crassicauda	Lygosoma_crassicaudum	Sphenomorphus_crassicaudus	Glaphyromorphus_crassicauda
Eremiascincus_timorensis	Glaphyromorphus_timorensis	Eremiascincus_timorensis
Eremiascincus_butlerorum	Glaphyromorphus_butlerorum	Eremiascincus_butlerorum
Anomalopus_brevicollis	Anomalopus_brevicollis	Praeteropus_brevicollis
Anomalopus_gowi	Anomalopus_gowi	Praeteropus_gowi
Hemiergis_quadrilineata	Chelomeles_quadrilineatus	Hemiergis_quadralineata	Lygosoma_quadrilineatum	Hemiergis_quadrilineatus
Sphenomorphus_apalpebratus	Sphenomorphus_apalpebratus
Scincella_inconspicua	Lygosoma_inconspicuum	Scincella_inconspicua	Lipinia_inconspicua
Scincella_schmidti	Leiolopisma_schmidti	Scincella_schmidti
Scincella_forbesora	Leiolopisma_forbesorum	Scincella_forbesorum
Scincella_rara	Paralipinia_rara	Scincella_rara
Scincella_assatus	Lampropholis_assatus	Leiolopisma_assatum_taylori	Sphenomorphus_assatus	Scincella_assata
Scincella_macrotis	Euprepes_macrotis	Lygosoma_macrotis	Scincella_macrotis
Scincella_apraefrontalis	Scincella_apraefrontalis
Scincella_capitanea	Scincella_capitanea
Scincella_przewalskii	Lygosoma_przewalskii	Scincella_przewalskii
Scincella_rufocaudatus	Sphenomorphus_rufocaudatus	Scincella_rufocaudata
Papuascincus_phaeodes	Lygosoma_phaeodes	Papuascincus_phaeodes
Lipinia_noctua	Euprepes_novarae	Lipinia_noctua	Lipinia_noctua_noctua	Lygosoma_miotis	Lygosoma_vertebrale	Scincus_noctua	Ornithuroscincus_noctua
Prasinohaema_parkeri	Lygosoma_parkeri	Prasinohaema_parkeri
Lipinia_nitens	Lygosoma_nitens	Lipinia_nitens
Lipinia_inexpectata	Lipinia_inexpectata
Lipinia_miangensis	Lipinia_miangense	Lygosoma_miangensis	Lipinia_miangensis
Lipinia_pulchra	Lipinia_pulchra	Lygosoma_pulchrum	Palaia_pulchra
Lipinia_venemai	Lipinia_venemai
Lipinia_albodorsalis	?_albodorsalis	Lipinia_albodorsalis	Lygosoma_albodorsale	Ornithuroscincus_albodorsalis
Lipinia_nototaenia	Lipinia_nototaenia	Lygosoma_nototaenia	Ornithuroscincus_nototaenia
Sphenomorphus_tonkinensis	Sphenomorphus_tonkinensis
Tropidophorus_hangnam	Tropidophorus_hangnam
Tropidophorus_noggei	Tropidophorus_noggei
Tropidophorus_guangxiensis	Tropidophorus_guangxiensis
Tropidophorus_iniquus	Tropidophorus_iniquus
Pseudoacontias_unicolor	Pseudoacontias_unicolor
Pseudoacontias_angelorum	Pseudoacontias_angelorum
Pseudoacontias_menamainty	Pseudoacontias_menamainty
Pseudoacontias_madagascariensis	Pseudoacontias_madagascariensis	Pseudoacontias_madagascariensis
Androngo_trivittatus	Androngo_trivittatus	Scelotes_trilineatus	Pygomeles_trivittatus
Chabanaudia_boulengeri	Chabanaudia_boulengeri	Feylinia_boulengeri
Voeltzkowia_lineata	Grandidierina_lineata	Voeltzkowia_lineata	Grandidierina_lineata
Voeltzkowia_rubrocaudata	Acontias_rubrocaudatus	Voeltzkowia_rubrocaudata	Grandidierina_rubrocaudata
Voeltzkowia_fierinensis	Scelotes_fierinensis	Voeltzkowia_fierinensis	Grandidierina_fierinensis
Voeltzkowia_petiti	Grandidierina_petiti	Voeltzkowia_petiti	Grandidierina_petiti
Amphiglossus_mandady	Amphiglossus_mandady	Brachyseps_mandady
Amphiglossus_tsaratananensis	Amphiglossus_tsaratananensis	Scelotes_tsaratananensis	Flexiseps_tsaratananensis
Amphiglossus_decaryi	Amphiglossus_decaryi	Scelotes_decaryi	Flexiseps_decaryi
Amphiglossus_splendidus	Amphiglossus_splendidus	Gongylus_splendidus	Brachyseps_splendidus
Amphiglossus_elongatus	Amphiglossus_elongatus	Androngo_elongatus	Scelotes_elongatus	Flexiseps_elongatus
Amphiglossus_anosyensis	Amphiglossus_anosyensis	Brachyseps_anosyensis
Amphiglossus_andranovahensis	Amphiglossus_andranovahensis	Scelotes_andranovahensis	Flexiseps_andranovahensis
Amphiglossus_macrocercus	Amphiglossus_macrocercus	Gongylus_macrocercus	Brachyseps_macrocercus
Amphiglossus_punctatus	Amphiglossus_punctatus	Brachyseps_punctatus
Amphiglossus_frontoparietalis	Amphiglossus_frontoparietalis	Amphiglossus_praeornatus	Scelotes_frontoparietalis	Scelotes_praeornatus	Sepsina_frontoparietalis	Brachyseps_frontoparietalis
Amphiglossus_stylus	Amphiglossus_stylus	Flexiseps_stylus
Amphiglossus_alluaudi	Amphiglossus_alluaudi	Androngo_alluaudi	Scelotes_alluaudi	Flexiseps_alluaudi
Amphiglossus_meva	Amphiglossus_meva	Flexiseps_meva
Amphiglossus_crenni	Amphiglossus_crenni	Androngo_crenni	Scelotes_crenni	Sepsina_crenni	Flexiseps_crenni
Amphiglossus_johannae	Amphiglossus_johannae	Gongylus_johannae	Gongylus_teres	Scelotes_johannae	Flexiseps_johannae
Amphiglossus_ardouini	Amphiglossus_ardouini	Scelotes_ardouini	Sepsina_ardouini	Flexiseps_ardouini
Amphiglossus_mandokava	Amphiglossus_mandokava	Flexiseps_mandokava
Amphiglossus_gastrostictus	Amphiglossus_gastrostictus	Gongylus_gastrostictus	Brachyseps_gastrostictus
Amphiglossus_spilostichus	Amphiglossus_spilostichus	Brachyseps_spilostichus
Amphiglossus_tanysoma	Amphiglossus_tanysoma	Flexiseps_tanysoma
Amphiglossus_valhallae	Amphiglossus_valhallae	Scelotes_valhallae	Sepsina_valhallae	Flexiseps_valhallae
Amphiglossus_ornaticeps	Amphiglossus_ornaticeps	Sepsina_ornaticeps	Flexiseps_ornaticeps
Amphiglossus_melanurus	Amphiglossus_melanurus	Amphiglossus_poecilopus	Gongylus_melanurus	Scelotes_melanurus	Scelotes_poecilopus	Sepsina_melanura	Flexiseps_melanurus
Paracontias_kankana	Paracontias_kankana_kohler	Paracontias_kankana
Paracontias_rothschildi	Paracontias_rothschildi
Paracontias_tsararano	Paracontias_tsararano
Paracontias_hafa	Paracontias_hafa
Paracontias_fasika	Paracontias_fasika_kohler	Paracontias_fasika
Paracontias_minimus	Cryptoposcincus_minimus	Cryptoscincus_minimus	Paracontias_minimus
Paracontias_manify	Paracontias_manify
Paracontias_vermisaurus	Paracontias_vermisaurus
Madascincus_ankodabensis	Scelotes_ankodabensis	Madascincus_ankodabensis
Madascincus_mouroundavae	Gongylus_mouroundavae	Scelotes_bellyi	Madascincus_mouroundavae
Madascincus_macrolepis	Scelotes_macrolepis	Madascincus_macrolepis
Madascincus_arenicola	Madascincus_arenicola
Nessia_deraniyagalai	Nessia_deraniyagalai
Nessia_hickanala	Nessia_hickanala
Sepsina_bayoni	Dumerilia_bayoni	Scincodipus_congicus	Sepsina_bayonii
Typhlacontias_rudebecki	Typhlacontias_rudebecki
Typhlacontias_johnsonii	Typhlacontias_johnsonii
Feylinia_macrolepis	Feylinia_macrolepis
Melanoseps_emmrichi	Melanoseps_emmrichi	Melanoseps_emmrichi
Sirenoscincus_mobydick	Sirenoscincus_mobydick	Voeltzkowia_mobydick
Sirenoscincus_yamagishii	Sirenoscincus_yamagishii	Voeltzkowia_yamagishii
Scelotes_duttoni	Scelotes_duttoni
Scelotes_poensis	Melanoseps_poensis	Scelotes_poensis
Scelotes_schebeni	Herpetosaura_occidentalis	Scelotes_schebeni	Melanoseps_occidentalis
Scelotes_bourquini	Scelotes_bourquini	Scelotes_guentheri_parte	Scelotes_guentheri
Scelotes_insularis	Scelotes_arenicola_insularis	Scelotes_insularis
Scelotes_bicolor	Herpetosaura_arenicola	Lithophilus_bicolor	Scelotes_bicolor	Scelotes_arenicolus
Chalcides_ebneri	Chalcides_ebneri
Chalcides_manueli	Chalcides_manueli
Chalcides_pentadactylus	Sphenocephalus_pentadactylus	Chalcides_pentadactylus
Ophiomorus_blanfordi	Ophiomorus_blanfordi	Zygnidopsis_brevipes	Ophiomorus_blanfordii
Plestiodon_popei	Eumeces_popei	Plestiodon_popei
Plestiodon_kuchinoshimensis	Plestiodon_kuchinoshimensis
Plestiodon_coreensis	Eumeces_coreensis	Plestiodon_coreensis
Barkudia_melanosticta	Anguis_melanostictus	Barkudia_melanosticta
Scolecoseps_litipoensis	Scolecoseps_litipoensis
Eurylepis_poonaensis	Eumeces_poonaensis	Eurylepis_poonaensis
Eumeces_cholistanensis	Eumeces_cholistanensis
Eumeces_indothalensis	Novoeumeces_indothalensis	Eumeces_indothalensis
Eumeces_schneideri	Eumeces_pavimentatus	Eumeces_pavimentatus_syriaca	Eumeces_schneideri	Euprepes_princeps	Euprepis_princeps	Novoeumeces_schneiderii	Plestiodon_aldrovandi	Scincus_pavimentatus	Scincus_schneideri	Scincus_schneiderii	Eumeces_schneiderii
Acontias_schmitzi	Acontias_schmitzi
Acontias_poecilus	Acontias_niger	Acontias_plumbea	Acontias_poecilus	Acontias_plumbeus
Cnemaspis_boulengerii	Cnemaspis_boulengeri
Cnemaspis_jacobsoni	Cnemaspis_jacobsoni
Cnemaspis_laoensis	Cnemaspis_laoensis
Cnemaspis_argus	Cnemaspis_argus
Cnemaspis_harimau	Cnemaspis_harimau
Cnemaspis_affinis
Cnemaspis_timoriensis	Cnemaspis_timoriensis
Alsophylax_szczerbaki	Alsophylax_loricatus_szczerbaki	Alsophylax_szczerbaki
Alsophylax_loricatus	Alsophylax_loricatus
Cyrtodactylus_fasciolatum	?_fasciolatus	Cyrtopodion_fasciolatum	Gymnodactylus_fasciolatus	Cyrtodactylus_fasciolatus
Cyrtodactylus_nepalensis	Cyrtopodion_nepalensis	Gonydactylus_nepalensis	Siwaligekko_nepalensis	Cyrtodactylus_nepalensis
Cyrtodactylus_malcolmsmithi	Cyrtodactylus_malcolmsmithi	Cyrtodactylus_malcomsmithi	Gymnodactylus_malcolmsmithi	Hemidactylus_malcolmsmithi
Cyrtodactylus_vilaphongi	Cyrtodactylus_vilaphongi
Cyrtodactylus_sworderi	Gymnodactylus_sworderi	Gymnodactylus_sworderi	Cyrtodactylus_sworderi
Cyrtodactylus_tamaiensis	Cyrtodactylus_khasiensis_tamaiensis	Gymnodactylus_khasiensis_tamaiensis	Cyrtodactylus_tamaiensis
Cyrtodactylus_cucphuongensis	Cyrtodactylus_cucphuongensis	Cyrtodactylus_cucphuongensis
Cyrtodactylus_batik	Cyrtodactylus_batik
Cyrtodactylus_pantiensis	Cyrtodactylus_pantiensis
Cyrtodactylus_phuquocensis	Cyrtodactylus_phuquocensis
Cyrtodactylus_hikidai	Cyrtodactylus_hikidai
Cyrtodactylus_bichnganae	Cyrtodactylus_bichnganae
Cyrtodactylus_seribuatensis	Cyrtodactylus_seribuatensis
Cyrtodactylus_batucolus	Cyrtodactylus_batucolus
Cyrtodactylus_eisenmanae	Cyrtodactylus_eisenmanae
Cyrtodactylus_phuocbinhensis	Cyrtodactylus_phuocbinhensis
Cyrtodactylus_aurensis	Cyrtodactylus_aurensis
Cyrtodactylus_subsolanus	Cyrtodactylus_subsolanus
Cyrtodactylus_thochuensis	Cyrtodactylus_thochuensis
Cyrtodactylus_serratus	Cyrtodactylus_serratus
Cyrtodactylus_badenensis	Cyrtodactylus_badenensis
Cyrtodactylus_cryptus	Cyrtodactylus_cryptus
Cyrtodactylus_huynhi	Cyrtodactylus_huynhi
Cyrtodactylus_dati	Cyrtodactylus_dati
Cyrtodactylus_deveti	Gymnodactylus_deveti	Cyrtodactylus_deveti
Cyrtodactylus_caovansungi	Cyrtodactylus_caovansungi
Cyrtodactylus_yangbayensis	Cyrtodactylus_yangbayensis	Cyrtodactylus_yangbayensis
Cyrtodactylus_ramboda	Cyrtodactylus_ramboda
Cyrtodactylus_cucdongensis	Cyrtodactylus_cucdongensis
Cyrtodactylus_matsuii	Gonodactylus_matsuii	Cyrtodactylus_matsuii
Cyrtodactylus_martinstolli	Cyrtopodion_martinstolli	Gonydactylus_martinstolli	Gymnodactylus_martinstollii	Siwaligekko_martinstolli	Cyrtodactylus_martinstolli
Cyrtodactylus_wangkulangkulae	Cyrtodactylus_wangkulangkulae
Cyrtodactylus_stresemanni	Cyrtodactylus_stresemanni_rosler	Cyrtodactylus_stresemanni
Cyrtodactylus_leegrismeri	Cyrtodactylus_leegrismeri
Cyrtodactylus_roesleri	Cyrtodactylus_roesleri
Cyrtodactylus_pageli	Cyrtodactylus_pageli
Cyrtodactylus_nigriocularis	Cyrtodactylus_nigriocularis
Cyrtodactylus_puhuensis	Cyrtodactylus_puhuensis
Cyrtodactylus_zhaoermii	Cyrtodactylus_zhaoermii
Cyrtodactylus_minor	Cyrtodactylus_minor
Cyrtodactylus_sharkari	Cyrtodactylus_sharkari
Cyrtodactylus_timur	Cyrtodactylus_timur
Cyrtodactylus_martini	Cyrtodactylus_martini
Cyrtodactylus_jarakensis	Cyrtodactylus_jarakensis
Cyrtodactylus_variegatus	Gymnodactylus_variegatus	Naultinus_variegatus	Cyrtodactylus_variegatus
Cyrtodactylus_arcanus	Cyrtodactylus_aenigma	Cyrtodactylus_arcanus
Cyrtodactylus_durio	Cyrtodactylus_durio
Cyrtodactylus_boreoclivus	Cyrtodactylus_boreoclivus
Cyrtodactylus_hontreensis	Cyrtodactylus_hontreensis	Cyrtodactylus_hontreensis
Cyrtodactylus_saiyok	Cyrtodactylus_saiyok
Cyrtodactylus_metropolis	Cyrtodactylus_metropolis
Cyrtodactylus_thuongae	Cyrtodactylus_thuongae
Cyrtodactylus_markuscombaii	Cyrtopodion_markuscombaii	Gonydactylus_markuscombaii	Gymnodactylus_marcuscombaii	Siwaligekko_markuscombaii	Cyrtodactylus_markuscombaii
Cyrtodactylus_edwardtaylori	Cyrtodactylus_edwardtaylori
Cyrtodactylus_nuaulu	Cyrtodactylus_nuaulu
Cyrtodactylus_chauquangensis	Cyrtodactylus_chauquangensis
Cyrtodactylus_irianjayaensis	Cyrtodactylus_irianjayaensis
Cyrtopodion_lawderanum	Cyrtodactylus_himalayensis	Cyrtopodion_lawderanum	Gymnodactylus_lawderanus	Siwaligekko_lawderanus	Cyrtodactylus_lawderanus
Cyrtopodion_himalayanum	Cyrtopodion_himalayanum	Cyrtodactylus_himalayanus
Cyrtopodion_battalense	Cyrtopodion_battalense	Siwaligekko_battalensis	Tenuidactylus_battalensis	Cyrtodactylus_battalensis
Hemidactylus_kundaensis	Hemidactylus_kundaensis	Hemidactylus_kundaensis
Hemidactylus_klauberi	Hemidactylus_klauberi
Hemidactylus_albivertebralis	Hemidactylus_albivertebralis	Hemidactylus_albivertebralis
Hemidactylus_makolowodei	Hemidactylus_makolowodei
Hemidactylus_aporus	Hemidactylus_aporus
Hemidactylus_newtoni	Hemidactylus_newtoni
Hemidactylus_lopezjuradoi	Hemidactylus_lopezjuradoi
Hemidactylus_bouvieri	Emydactylus_bouvieri	Hemidactylus_cessacii	Hemidactylus_bouvieri
Hemidactylus_endophis	Hemidactylus_endophis
Hemidactylus_ituriensis	Hemidactylus_ituriensis
Hemidactylus_masirahensis	Hemidactylus_masirahensis
Hemidactylus_kyaboboensis	Hemidactylus_kyaboboensis	Hemidactylus_kyaboboensis
Hemidactylus_oxyrhinus	Hemidactylus_oxyrhinus
Hemidactylus_forbesii	Hemidactylus_forbesii
Hemidactylus_shihraensis	Hemidactylus_shihraensis
Hemidactylus_granchii	Hemidactylus_granchii
Hemidactylus_jumailiae	Hemidactylus_jumailiae
Hemidactylus_dawudazraqi	Hemidactylus_dawudazraqi
Hemidactylus_mindiae	Hemidactylus_mindiae
Hemidactylus_lavadeserticus	Hemidactylus_lavadeserticus
Hemidactylus_jubensis	Hemidactylus_jubensis
Hemidactylus_ophiolepis	Hemidactylus_ophiolepis
Hemidactylus_anamallensis	Gecko_anamallensis	Hemidactylus_anamallensis	Hoplodactylus_anamallensis	Dravidogecko_anamallensis
Rhinogecko_misonnei	Agamura_misonnei	Rhinogecko_misonnei	Rhinogekko_misonnei	Rhinogekko_misonnei
Rhinogecko_femoralis	Agamura_femoralis	Rhinogecko_femoralis	Rhinogekko_femoralis
Stenodactylus_pulcher	Stenodactylus_pulcher
Stenodactylus_sharqiyahensis	Stenodactylus_sharqiyahensis	Trigonodactylus_sharqiyahensis
Stenodactylus_arabicus	Stenodactylus_arabicus	Trigonodactylus_arabicus
Stenodactylus_stenurus	Stenodactylus_stenurus
Tropiocolotes_scortecci	Tropiocolotes_scorteccii
Mediodactylus_brachykolon	Altigekko_brachykolon	Cyrtopodion_brachykolon	Mediodactylus_brachykolon
Mediodactylus_walli	Cyrtodactylus_chitralensis	Cyrtodactylus_walli	Cyrtopodion_walli	Gymnodactylus_chitralensis	Gymnodactylus_walli	Tenuidactylus_chitralensis	Tenuidactylus_walli	Mediodactylus_walli
Mediodactylus_narynensis	Cyrtopodion_narynensis	Mediodactylus_narynensis
Cyrtopodion_dattanense	Cyrtopodion_dattanense	Cyrtopodion_dattanensis	Gonydactylus_dattanensis	Gymnodactylus_dattanensis	Siwaligekko_dattanensis	Tenuidactylus_dattanensis	Cyrtodactylus_dattanensis
Cyrtopodion_fortmunroi	Indogekko_fortmunroi	Tenuidactylus_fortmunroi	Cyrtopodion_fortmunroi
Cyrtopodion_mansarulus	Cyrtodactylus_mansarulus	Cyrtopodion_mansarulus
Cyrtopodion_baigii	Cyrtopodion_baigii
Cyrtopodion_rhodocauda	Indogekko_rhodocaudus	Tenuidactylus_rhodocaudus	Cyrtopodion_rhodocauda
Bunopus_spatalurus	Bunopus_spatalurus	Trachydactylus_jolensis	Trachydactylus_spatalurus
Altiphylax_mintoni	Cyrtodactylus_mintoni	Cyrtopodion_mintoni	Gonydactylus_mintoni	Gymnodactylus_mintoni	Siwaligekko_mintoni	Tenuidactylus_mintoni	Altiphylax_mintoni
Altiphylax_yarkandensis
Pseudogekko_labialis	Gecko_labialis	Pseudogekko_labialis	Lepidodactylus_labialis
Pseudogekko_compressicorpus	Luperosaurus_compresicorpus	Pseudogekko_compresicorpus
Luperosaurus_kubli	Luperosaurus_kubli
Luperosaurus_iskandari	Luperosaurus_iskandari	Gekko_iskandari
Luperosaurus_yasumai	Luperosaurus_yasumai
Ptychozoon_kuhli	Lacerta_homalocephala	Ptychozoon_kuhli	Gekko_kuhli
Ptychozoon_trinotaterra	Ptychozoon_trinotaterra	Gekko_trinotaterra
Ptychozoon_intermedium	Ptychozoon_intermedium	Gekko_intermedium
Ptychozoon_horsfieldii	Platydactylus_horsfieldii	Pteropleura_horsfieldii	Ptychozoon_homalocephala	Ptychozoon_horsfieldii	Gekko_horsfieldii
Ptychozoon_kaengkrachanense	Ptychozoon_kaengkrachanense	Gekko_kaengkrachanense
Ptychozoon_lionotum	Ptychozoon_homalocephalum_lionotum	Ptychozoon_homalocephalum_lionotum	Ptychozoon_lionotum	Gekko_lionotum
Ptychozoon_nicobarensis	Ptychozoon_nicobarensis	Gekko_nicobarensis
Ptychozoon_rhacophorus	Gecko_rhacophorus	Ptychozoon_rhacophorus	Gekko_rhacophorus
Luperosaurus_browni	Luperosaurus_browni	Luperosaurus_serraticaudus	Gekko_browni
Lepidodactylus_gardineri	Lepidodactylus_gardineri
Gekko_taylori	Gekko_taylori	Gekko_siamensis
Gekko_auriverrucosus	Gekko_auriverrucosus
Luperosaurus_gulat	Luperosaurus_gulat	Gekko_gulat
Luperosaurus_sorok	Luperosaurus_sorok	Gekko_sorok
Luperosaurus_brooksii	Gekko_brooksi	Luperosaurus_brooksii
Lepidodactylus_planicaudus	Lepidodactylus_naujanensis	Lepidodactylus_planicauda
Gekko_wenxianensis	Gekko_wenxianensis
Gekko_taibaiensis	Gekko_taibaiensis
Gekko_russelltraini	Gekko_russelltraini	Gekko_russelltraini
Lepidodactylus_buleli	Lepidodactylus_buleli
Hemiphyllodactylus_engganoensis	Hemiphyllodactylus_engganoensis
Hemiphyllodactylus_aurantiacus	Hemidactylus_aurantiacus	Hemiphyllodactylus_typus_aurantiacus	Lepidodactylus_aurantiacus	Hemiphyllodactylus_aurantiacus
Hemiphyllodactylus_margarethae	Hemiphyllodactylus_margarethae
Hemiphyllodactylus_banaensis	Hemiphyllodactylus_banaensis
Hemiphyllodactylus_zugi	Hemiphyllodactylus_zugi
Hemiphyllodactylus_larutensis	Gehyra_larutensis	Hemiphyllodactylus_larutensis
Hemiphyllodactylus_tehtarik	Hemiphyllodactylus_tehtarik
Gehyra_fenestra	Gehyra_fenestra	Peropus_variegatus_punctatus	Gehyra_punctata
Gehyra_serraticauda	Gehyra_serraticauda
Gehyra_barea	Peropus_barea	Gehyra_barea
Gehyra_butleri	Gecko_pardus	Gehyra_beebei	Gehyra_butleri	Gehyra_harrieti	Gehyra_insulanus	Gehyra_mugtilata	Gehyra_mutila	Gehyra_packardii	Hemidactylus_mutilatus	Hemidactylus_mutilatus	Hemidactylus_navarii	Hemidactylus_navarri	Hemidactylus_peronii	Hemidactylus_platurus	Hemidactylus_platurus	Hemidactylus_pristiurus	Peripia_mutilata	Peropus_multilatus	Peropus_mutilatus	Peropus_packardii	Peropus_peronii	Gehyra_mutilata
Nactus_coindemirensis	Nactus_coindemerensis	Nactus_coindemirensis
Nactus_kunan	Nactus_kunan
Nactus_soniae	Nactus_borbonicus	Nactus_soniae
Heteronotia_fasciolatus	Heteronotia_fasciolata
Phelsuma_gigas	Gecko_newtoni	Gekko_newtoni	Phelsuma_gigas
Phelsuma_hoeschi	Phelsuma_hoeschi
Phelsuma_ravenala	Phelsuma_ravenala
Phelsuma_borai	Phelsuma_borai
Phelsuma_andamanense	Gecko_chameleon	Phelsuma_andamanense	Phelsuma_madagascariensis_andamanense	Phelsuma_andamanensis
Lygodactylus_blancae	Lygodactylus_blancae
Lygodactylus_decaryi	Lygodactylus_decaryi
Lygodactylus_luteopicturatus	Hemidactylus_picturatus	Hemidactylus_variegatus	Lygodactylus_griseus	Lygodactylus_luteopicturatus	Lygodactylus_luteopicturatus_luteopicturatus	Lygodactylus_luteopicturatus_zanzibaritis	Lygodactylus_picturatus_griseus	Lygodactylus_picturatus_quinquelineatus	Lygodactylus_picturatus_quinquestriata	Lygodactylus_picturatus_septemlineatus	Lygodactylus_quinquelineatus	Lygodactylus_septemlineatus	Lygodactylus_picturatus
Lygodactylus_howelli	Hemidactylus_viscatus	Lygodactylus_howelli	Lygodactylus_viscatus
Lygodactylus_regulus	Lygodactylus_regulus
Lygodactylus_grandisonae	Lygodactylus_grandisonae
Lygodactylus_ornatus	Lygodactylus_ornatus
Lygodactylus_intermedius	Lygodactylus_intermedius
Lygodactylus_montanus	Lygodactylus_montanus
Lygodactylus_roavolana	Lygodactylus_roavolana
Lygodactylus_rarus	Lygodactylus_rarus
Perochirus_guentheri	Perochirus_guentheri
Cnemaspis_gigas	Cnemaspis_gigas
Cnemaspis_koehleri	Cnemaspis_africana_koehleri	Cnemaspis_koehleri
Cnemaspis_petrodroma	Cnemaspis_petrodroma
Cnemaspis_dilepis	Cnemaspis_dilepis
Cnemaspis_alantika	Cnemaspis_alantika
Urocotyledon_weileri	Diplodactylus_weileri	Phyllodactylus_weileri	Urocotyledon_weileri
Paroedura_tanjaka	Paroedura_tanjaka
Paroedura_ibityensis	Paroedura_bastardi_ibityensis	Paroedura_ibityensis
Paroedura_hordiesi	Paroedura_hordiesi
Paroedura_vahiny	Paroedura_vahiny
Kolekanos_plumicaudus	Afrogecko_plumicaudus	Kolekanos_plumicauda
Afrogecko_ansorgii	Phyllodactylus_ansorgii	Afrogecko_ansorgii
Colopus_kochii	Colopus_kochii	Pachydactylus_kochii	Pachydactylus_kochii
Pachydactylus_goodi	Pachydactylus_goodi	Pachydactylus_weberi_parte	Pachydactylus_atorquatus
Pachydactylus_laevigatus	Pachydactylus_bibroni_laevigatus	Pachydactylus_laevigatus	Pachydactylus_turneri_laevigatus	Chondrodactylus_laevigatus
Colopus_wahlbergii	Colopus_kalaharicus	Colopus_wahlbergii	Colopus_wahlbergii_furcifer	Pachydactylus_wahlbergii
Afroedura_granitica	Afroedura_granitica
Afroedura_broadleyi	Afroedura_broadleyi
Afroedura_tirasensis	Afroedura_africana_tirasensis	Afroedura_tirasensis
Afroedura_rondavelica	Afroedura_rondavelica
Microgecko_depressus	Asiocolotes_depressus	Tropiocolotes_depressus	Microgecko_depressus
Cnemaspis_jerdonii	Gonatodes_jerdoni	Gymnodactylus_jerdonii	Cnemaspis_jerdonii
Cnemaspis_boiei	Goniodactylus_boei	Cnemaspis_boiei
Cnemaspis_andersonii	Gonatodes_andersonii	Cnemaspis_andersonii
Cnemaspis_otai	Cnemaspis_otai
Cnemaspis_clivicola	Cnemaspis_clivicola	Cnemaspis_upendrai
Cnemaspis_podihuna	Cnemaspis_podihuna
Cnemaspis_wicksi	Gymnodactylus_wicksii	Cnemaspis_wicksi
Cnemaspis_anaikattiensis	Cnemaspis_anaikattiensis	Gonatodes_bireticulatus	Gonatodes_sisparensis	Gymnodactylus_maculatus	Gymnodactylus_sisparensis	Cnemaspis_sisparensis
Cnemaspis_monticola	Cnemaspis_monticola
Cnemaspis_amith	Cnemaspis_amith
Cnemaspis_indraneildasii	Cnemaspis_indraneildasii	Cnemaspis_goaensis
Tarentola_albertschwartzi	Tarentola_albertschwartzi
Tarentola_protogigas	Tarentola_borneensis_protogigas	Tarentola_rudis_hartogi	Tarentola_rudis_protogigas	Tarentola_rudis_rudis	Tarentola_protogigas
Tarentola_pastoria	Tarentola_pastoria
Tarentola_mindiae	Tarentola_mindiae
Tarentola_bischoffi	Tarentola_bischoffi	Tarentola_boettgeri
Phyllopezus_maranjonensis	Phyllopezus_maranjonensis
Gymnodactylus_vanzolinii	Gymnodactylus_vanzolinii
Phyllodactylus_heterurus	Diplodactylus_gerrhopygus	Phyllodactylus_heterurus	Phyllodactylus_gerrhopygus
Phyllodactylus_tinklei	Phyllodactylus_angelensis	Phyllodactylus_mentalis	Phyllodactylus_nocticolus	Phyllodactylus_tinklei	Phyllodactylus_xanti
Phyllodactylus_delsolari	Phyllodactylus_delsolari
Phyllodactylus_angelensis	Phyllodactylus_angelensis	Phyllodactylus_mentalis	Phyllodactylus_nocticolus	Phyllodactylus_tinklei	Phyllodactylus_xanti
Homonota_taragui	Homonota_taragui
Homonota_rupicola	Homonota_rupicola
Ptyodactylus_homolepis	Ptyodactylus_homolepis
Ptyodactylus_ananjevae	Ptyodactylus_ananjevae
Asaccus_saffinae	Asaccus_saffinae
Teratoscincus_toksunicus	Teratoscincus_toksunicus	Teratoscincus_roborowskii
Sphaerodactylus_nycteropus	Sphaerodactylus_nycteropus
Sphaerodactylus_storeyae	Sphaerodactylus_oliveri_storeyae	Sphaerodactylus_storeyae
Sphaerodactylus_bromeliarum	Sphaerodactylus_bromeliarum
Lepidoblepharis_oxycephalus	Gonatodes_oxycephalus	Lepidoblepharis_oxycephalus	Lepidoblepharis_intermedius
Gonatodes_purpurogularis	Gonatodes_purpurogularis
Gonatodes_petersi	Gonatodes_petersi
Gonatodes_daudini	Gonatodes_daudini
Gonatodes_fuscus
Gonatodes_infernalis	Gonatodes_infernalis
Gonatodes_nascimentoi	Gonatodes_nascimentoi	Gonatodes_nascimentoi
Gonatodes_superciliaris	Gonatodes_superciliaris
Gonatodes_naufragus	Gonatodes_naufragus
Gonatodes_astralis	Gonatodes_astralis
Gonatodes_lichenosus	Gonatodes_lichenosus
Pseudogonatodes_gasconi	Pseudogonatodes_gasconi
Coleodactylus_natalensis	Coleodactylus_natalensis
Coleodactylus_elizae	Coleodactylus_elizae
Pristurus_mazbah	Pristurus_mazbah
Pristurus_insignoides	Pristurus_insignoides
Pristurus_longipes	Pristurus_longipes
Pristurus_ornithocephalus	Pristurus_ornithocephalus
Pristurus_saada	Pristurus_saada
Pristurus_schneideri	Pristurus_schneideri
Goniurosaurus_huuliensis	Goniurosaurus_huuliensis
Goniurosaurus_toyamai	Goniurosaurus_kuroiwae_toyamai	Goniurosaurus_toyami	Goniurosaurus_toyamai
Goniurosaurus_zhelongi	Goniurosaurus_zhelongi
Goniurosaurus_yingdeensis	Goniurosaurus_yingdeensis
Goniurosaurus_orientalis	Eublepharis_orientalis	Goniurosaurus_kuroiwae_orientalis	Goniurosaurus_orientalis
Goniurosaurus_splendens	Eublepharis_splendens	Goniurosaurus_splendens
Holodactylus_cornii	Holodactylus_cornii
Delma_haroldi	Delma_haroldi	Delma_butleri
Woodworthia_maculatus	Hoplodactylus_maculatus	Naultinus_granulatus	Naultinus_maculatus	Woodworthia_digitata	Woodworthia_maculata
Woodworthia_brunneus	Pentadactylus_brunneus	Woodworthia_brunnea
Woodworthia_chrysosireticus	Hoplodactylus_chrysosireticus	Woodworthia_chrysosiretica
Hoplodactylus_delcourti	Hoplodactylus_delcourti
Paniegekko_madjo	Bavayia_madjo	Paniegekko_madjo
Eurydactylodes_occidentalis	Eurydactylodes_occidentalis
Bavayia_nubila	Bavayia_nubila
Bavayia_pulchella	Bavayia_pulchella
Dibamus_somsaki	Dibamus_somsaki
Dibamus_booliati	Dibamus_booliati
Dibamus_alfredi	Dibamus_alfredi
Dibamus_greeri	Dibamus_greeri
Dibamus_smithi	Dibamus_smithi
Dibamus_tiomanensis	Dibamus_tiomanensis
Dibamus_ingeri	Dibamus_ingeri
Dibamus_deharvengi	Dibamus_deharvengi
Dibamus_dezwaani	Dibamus_dezwaani
Dibamus_tebal	Dibamus_tebal
Dibamus_vorisi	Dibamus_vorisi
Dibamus_kondaoensis	Dibamus_kondaoensis
